aliquot_id	ova.nLOH	ova.LSTs	ova.nTAIs	ovaHRDscar	ova.HR.status	tnbc.nLOH	tnbc.LSTs	tnbc.nTAIs	tnbcHRDscar	tnbc.HR.status
0009b464-b376-4fbc-8a56-da538269a02f	26	4	27	57	HRD	19	33	27	79	HRD
003819bc-c415-4e76-887c-931d60ed39e7	0	0	0	0	HRP	0	0	0	0	HRP
0040b1b6-b07a-4b6e-90ef-133523eaf412	5	10	9	24	HRP	5	15	9	29	HRP
00493087-9d9d-40ca-86d5-936f1b951c93	2	1	3	6	HRP	1	1	3	5	HRP
00508f2b-36bf-44fc-b66b-97e1f3e40bfa	14	4	6	24	HRP	9	16	6	31	HRP
005794f1-5a87-45b5-9811-83ddf6924568	0	0	1	1	HRP	0	0	1	1	HRP
005e85a3-3571-462d-8dc9-2babfc7ace21	1	2	0	3	HRP	0	6	0	6	HRP
007aab66-2f07-459d-8952-3041d6ea24a8	1	0	1	2	HRP	1	0	1	2	HRP
008aef39-0c97-48ce-9dfd-f12d67116c59	5	6	1	12	HRP	4	11	1	16	HRP
008bad10-d41b-4bbb-86fa-9976ecea46b1	0	0	2	2	HRP	0	5	2	7	HRP
00aa769d-622c-433e-8a8a-63fb5c41ea42	1	0	1	2	HRP	1	0	1	2	HRP
00b9d0e6-69dc-4345-bffd-ce32880c8eef	2	3	2	7	HRP	1	4	2	7	HRP
00bf0350-8c7c-4b9e-8143-13ea2dc1122f	0	0	2	2	HRP	0	1	2	3	HRP
00c27940-c623-11e3-bf01-24c6515278c0	7	1	7	15	HRP	3	5	7	15	HRP
00db1b95-8ca3-4cc4-bb46-6b8c8019a7c7	2	2	12	16	HRP	0	7	12	19	HRP
00db4dc2-3ec7-4ff9-9233-d69c8c8a607f	13	6	12	31	HRP	8	22	12	42	HRP
01658141-8398-4585-9f0f-8355dd9b0604	17	11	28	56	HRD	14	29	28	71	HRD
0168a2a6-c3af-4d58-a51c-d33f0fc7876d	1	3	4	8	HRP	0	5	4	9	HRP
0176cf1d-0760-4769-a493-277f4bb7585e	13	3	10	26	HRP	11	7	10	28	HRP
0192d529-7340-45d8-a5f0-249cbb11ca19	3	1	2	6	HRP	3	1	2	6	HRP
01b0848c-ae36-4ade-a3da-d297b003c99f	21	15	24	60	HRD	13	42	24	79	HRD
01c8e465-2b4e-4519-bdef-c3ac06b43eeb	1	1	3	5	HRP	1	2	3	6	HRP
01dc6872-c623-11e3-bf01-24c6515278c0	2	1	3	6	HRP	1	1	3	5	HRP
01df36af-3617-40fc-9892-f54ce433cf71	5	9	17	31	HRP	3	18	17	38	HRP
02078f77-2b35-4fa3-ab02-2c017181295e	0	0	0	0	HRP	0	0	0	0	HRP
020fab36-c7de-4933-b2bf-dc7b019a1326	13	2	17	32	HRP	11	19	17	47	HRP
0250e6f7-2538-4d1f-a8ff-ca34a7057dde	26	11	16	53	HRP	20	23	16	59	HRD
02706819-bcab-4c49-a569-a4a8c60db1c0	0	0	0	0	HRP	0	0	0	0	HRP
02917220-6a7a-46a1-8656-907e96bef88e	8	6	6	20	HRP	7	7	6	20	HRP
0292a46f-a282-4b7f-a7d6-ac55cc7324fb	0	0	0	0	HRP	0	0	0	0	HRP
02c6a893-49c5-49d1-8eb1-195021e70d52	4	6	6	16	HRP	2	10	6	18	HRP
02c97e2b-914e-4afc-bf50-78f0cfbfa67b	9	6	12	27	HRP	7	10	12	29	HRP
02e5c36f-5bec-45e2-a048-875653b85ca1	4	2	7	13	HRP	2	6	7	15	HRP
030695f6-c623-11e3-bf01-24c6515278c0	13	3	13	29	HRP	8	12	13	33	HRP
031962d6-fc7d-4c6c-9d47-ffa45997b249	3	0	3	6	HRP	3	1	3	7	HRP
0332b017-17d5-4083-8fc4-9d6f8fdbbbde	0	1	5	6	HRP	0	1	5	6	HRP
0363fe2c-d765-450e-8b1a-d13a23d9af2a	0	0	0	0	HRP	0	0	0	0	HRP
0385961e-ea99-40b2-ad79-6872bc30d8a1	0	0	1	1	HRP	0	1	1	2	HRP
03ad38a6-0902-4aaa-84a3-91ea88fa9883	0	0	2	2	HRP	0	2	2	4	HRP
03b5268e-881e-49e7-824f-170c3fc8b11b	1	7	8	16	HRP	1	9	8	18	HRP
03c3c692-8a86-4843-85ae-e045f0fa6f88	13	17	18	48	HRP	10	42	18	70	HRD
03c88506-d72e-4a44-a34e-a7f0564f1799	3	3	5	11	HRP	2	7	5	14	HRP
03ced0ce-186a-4349-8d98-572c2bc90382	20	10	23	53	HRP	15	26	23	64	HRD
03cff38d-7e29-4409-a508-749bddb1b3df	25	7	19	51	HRP	19	22	19	60	HRD
041e3b42-c623-11e3-bf01-24c6515278c0	4	1	7	12	HRP	3	6	7	16	HRP
04339769-517c-448d-a7ca-951f83608c60	4	2	6	12	HRP	2	3	6	11	HRP
0448206f-3ade-4087-b1a9-4fb2d14e1367	33	7	31	71	HRD	23	54	31	108	HRD
046d7386-95c8-4501-9e55-c85bec272a7a	13	10	14	37	HRP	11	25	14	50	HRP
047f9e4d-86b5-4943-aef5-68199bf29e8c	5	5	10	20	HRP	3	13	10	26	HRP
04aa6b77-8074-480c-872e-a1a47afa5314	7	3	9	19	HRP	3	7	9	19	HRP
04b570c2-3224-4e9b-81cc-089b4a7ff07a	0	0	0	0	HRP	0	0	0	0	HRP
04b9837e-9ab5-4eb9-9a9c-ef49e3a62662	4	6	12	22	HRP	3	7	12	22	HRP
04c09376-8756-41d9-bbca-f464170a8cfb	5	2	7	14	HRP	2	7	7	16	HRP
04db8bef-8777-48ac-bc2e-3c9acb103f48	1	1	2	4	HRP	1	1	2	4	HRP
05070acd-3ec1-44bb-9c32-26d3a483a72a	9	5	8	22	HRP	8	14	8	30	HRP
051cb117-16fd-459e-81e5-002eca2b7eea	1	0	0	1	HRP	1	0	0	1	HRP
052015bc-8c24-467c-8ff7-9e0dc4ad39fd	8	3	3	14	HRP	6	10	3	19	HRP
052665d1-ab75-4f40-be5a-b88154c8beed	15	7	17	39	HRP	13	18	17	48	HRP
05486349-24a4-4931-bf5f-c9fefe369af2	7	1	7	15	HRP	4	2	7	13	HRP
0554ffe5-31f7-43f5-8372-2b73c9cf3527	4	2	5	11	HRP	3	3	5	11	HRP
05616329-e7ba-4efd-87b1-d79cd0f7af3d	1	6	4	11	HRP	0	11	4	15	HRP
0567d3e6-6278-4d0a-81ae-c084d73c6dd3	0	0	0	0	HRP	0	0	0	0	HRP
05780d48-80e7-4d70-b00c-081f8a9519f2	2	1	3	6	HRP	2	2	3	7	HRP
05c487aa-72d8-42e6-aa2b-b9b5ce273f5c	0	0	0	0	HRP	0	0	0	0	HRP
05da3161-1444-4188-914d-19762de3a443	0	0	0	0	HRP	0	0	0	0	HRP
06018aae-1107-4899-bd24-14e6b1f94709	0	0	0	0	HRP	0	0	0	0	HRP
0609b182-0396-4755-b463-10f949c5b8bb	2	1	3	6	HRP	2	1	3	6	HRP
0624eb1d-3aff-4037-a3c5-fc363a9edd02	2	1	3	6	HRP	2	2	3	7	HRP
062e96d4-c623-11e3-bf01-24c6515278c0	8	2	9	19	HRP	6	11	9	26	HRP
063cfacf-9933-4a2d-8921-0aeb76e12779	1	1	1	3	HRP	0	1	1	2	HRP
0664753b-7566-41e0-8006-7009c6735406	5	4	4	13	HRP	4	11	4	19	HRP
068f4f69-d2fe-4f25-912e-ca7d4623efb6	0	0	3	3	HRP	0	2	3	5	HRP
06dad93a-4b67-49b3-8fa5-f2546e22bae7	8	4	13	25	HRP	5	15	13	33	HRP
06ecd127-6c24-422d-a7fb-bf5aee1b8b7b	6	2	8	16	HRP	3	10	8	21	HRP
072f4146-c623-11e3-bf01-24c6515278c0	2	0	1	3	HRP	2	2	1	5	HRP
074fd614-5d9c-4bcc-96ad-351aa14387e3	2	2	3	7	HRP	2	4	3	9	HRP
07531318-87e8-4db8-aa61-9b93597d063b	1	2	0	3	HRP	1	2	0	3	HRP
075fc96d-6742-4ef3-9369-482592ad3a2f	10	2	13	25	HRP	9	11	13	33	HRP
07835447-5d7e-4828-80fd-89b063989c9a	3	4	4	11	HRP	1	6	4	11	HRP
079bcb09-a075-4313-9a3e-dd67734a8c5d	8	6	11	25	HRP	7	10	11	28	HRP
07a7c634-bd9a-4fc2-b9fe-87b060ec3d1f	1	1	0	2	HRP	0	1	0	1	HRP
07b5141f-ac79-439b-883b-b0183bbe7ff5	23	13	21	57	HRD	18	32	21	71	HRD
07d20658-3db4-47e7-877b-66536266edfc	6	4	8	18	HRP	4	5	8	17	HRP
07e0e938-f61f-477a-92a2-5b7e74b78943	12	5	8	25	HRP	7	8	8	23	HRP
07f16397-71bb-4594-ad4d-caa7d2baeabd	3	6	0	9	HRP	3	9	0	12	HRP
080ecc31-756a-4a1b-a51e-d632ac8219f7	6	3	9	18	HRP	5	8	9	22	HRP
08227616-02a5-46e8-9db1-f2d1d691ab23	18	9	21	48	HRP	15	18	21	54	HRD
0831e45e-c623-11e3-bf01-24c6515278c0	5	9	9	23	HRP	5	12	9	26	HRP
089be98d-c3c9-4fb4-aef2-7a8578a91d51	8	5	3	16	HRP	6	12	3	21	HRP
08ac57ec-0036-4134-a9bb-f22eaa27ab0d	6	2	4	12	HRP	3	6	4	13	HRP
08b5d0e4-4661-460e-a9f7-f2e687414711	5	2	7	14	HRP	3	3	7	13	HRP
08d2a566-8407-4e9b-836c-bf5e1e9f85b2	0	0	0	0	HRP	0	0	0	0	HRP
08e1d976-6c39-428e-a4c2-f655b675683e	0	0	0	0	HRP	0	0	0	0	HRP
08f7812b-0d74-42ba-985b-d0a027e8a80c	1	2	0	3	HRP	1	2	0	3	HRP
09497b9b-6fca-48cb-af97-161a3e434a51	21	6	28	55	HRD	20	33	28	81	HRD
09508a0d-ebe0-4fa1-b7b2-1710814181cd	12	0	23	35	HRP	11	47	23	81	HRD
09537dce-c797-4b60-962a-d4c3cd6ab00a	3	0	2	5	HRP	1	0	2	3	HRP
0972bfcf-c6c6-48cc-b820-cdfa6279a4f3	11	3	15	29	HRP	9	10	15	34	HRP
097a7d36-905b-72be-e050-11ac0d482c9a	5	6	7	18	HRP	4	14	7	25	HRP
0980e7fd-051d-45e9-9ca6-2baf073da4e8	1	5	5	11	HRP	0	5	5	10	HRP
09bc8542-4ea1-4599-91b3-d606425b37e2	17	5	21	43	HRP	11	26	21	58	HRD
09cb8bc5-13ac-44ac-9b7d-6de143373570	8	3	10	21	HRP	4	8	10	22	HRP
09e1fe3e-bfd8-4175-ac42-0e1bf0ba5523	7	5	2	14	HRP	7	10	2	19	HRP
0a6be23a-d5a0-4e95-ada2-a61b2b5d9485	3	0	2	5	HRP	1	3	2	6	HRP
0a9c9db0-c623-11e3-bf01-24c6515278c0	4	6	9	19	HRP	4	9	9	22	HRP
0ab4d782-9a50-48b9-96e4-6ce42b2ea034	7	3	8	18	HRP	3	5	8	16	HRP
0ae2193f-0d68-485a-b8c2-7568cbcce33e	2	3	5	10	HRP	1	6	5	12	HRP
0b19bee7-5281-4915-9d98-c20eb3e84ecf	12	11	15	38	HRP	9	19	15	43	HRP
0b29c893-03bf-4131-b192-c14a2788d411	1	1	5	7	HRP	1	2	5	8	HRP
0b6cd7df-6970-4d60-b7b5-85002a7d8781	0	0	0	0	HRP	0	0	0	0	HRP
0b811c6a-8f05-44bd-ac33-fb720d189e71	0	0	1	1	HRP	0	0	1	1	HRP
0ba8f2e2-935a-4123-86aa-6e7f5de85bf4	0	0	1	1	HRP	0	0	1	1	HRP
0bafd9ae-64b3-492d-a6fd-12aa8edefcbe	3	3	0	6	HRP	3	8	0	11	HRP
0bbc7ede-5022-4084-925c-d65baaf7abc2	26	12	24	62	HRD	15	20	24	59	HRD
0bd3a230-531e-44aa-9999-b8ed8da0176b	1	1	0	2	HRP	1	3	0	4	HRP
0be08326-c623-11e3-bf01-24c6515278c0	8	3	10	21	HRP	3	5	10	18	HRP
0bfd1043-5142-3662-e050-11ac0c486501	11	11	21	43	HRP	7	25	21	53	HRD
0bfd1043-70fb-d2dc-e050-11ac0c4860cb	13	10	20	43	HRP	8	24	20	52	HRP
0bfd1043-7343-fdd0-e050-11ac0c484cab	8	13	25	46	HRP	6	37	25	68	HRD
0bfd1043-7344-fdd0-e050-11ac0c484cab	7	4	18	29	HRP	7	37	18	62	HRD
0bfd1043-7346-fdd0-e050-11ac0c484cab	4	10	10	24	HRP	3	13	10	26	HRP
0bfd1043-7ebf-aaec-e050-11ac0c482f39	6	11	16	33	HRP	4	24	16	44	HRP
0bfd1043-7ec1-aaec-e050-11ac0c482f39	12	12	13	37	HRP	9	24	13	46	HRP
0bfd1043-7ed6-9ccc-e050-11ac0c481957	4	8	6	18	HRP	3	11	6	20	HRP
0bfd1043-816e-e3e4-e050-11ac0c4860c5	9	3	17	29	HRP	8	39	17	64	HRD
0bfd1043-8170-e3e4-e050-11ac0c4860c5	12	13	24	49	HRP	8	34	24	66	HRD
0bfd1043-8172-e3e4-e050-11ac0c4860c5	14	10	23	47	HRP	11	28	23	62	HRD
0bfd1043-8173-e3e4-e050-11ac0c4860c5	13	11	23	47	HRP	10	31	23	64	HRD
0bfd1043-8175-e3e4-e050-11ac0c4860c5	12	8	23	43	HRP	9	29	23	61	HRD
0bfd1043-8177-e3e4-e050-11ac0c4860c5	5	4	6	15	HRP	3	8	6	17	HRP
0bfd1043-817c-e3e4-e050-11ac0c4860c5	12	14	14	40	HRP	9	24	14	47	HRP
0bfd1043-817e-e3e4-e050-11ac0c4860c5	17	19	13	49	HRP	11	41	13	65	HRD
0bfd1043-8180-e3e4-e050-11ac0c4860c5	18	23	23	64	HRD	17	50	23	90	HRD
0bfd1043-8181-e3e4-e050-11ac0c4860c5	16	19	24	59	HRD	13	49	24	86	HRD
0bfd1043-8183-e3e4-e050-11ac0c4860c5	17	16	18	51	HRP	12	46	18	76	HRD
0bfd1043-8187-e3e4-e050-11ac0c4860c5	4	2	12	18	HRP	3	30	12	45	HRP
0bfd1043-8189-e3e4-e050-11ac0c4860c5	11	10	22	43	HRP	6	22	22	50	HRP
0bfd1068-3fc3-a95b-e050-11ac0c4860c3	13	9	23	45	HRP	10	29	23	62	HRD
0bfd1068-3fc5-a95b-e050-11ac0c4860c3	14	9	9	32	HRP	8	24	9	41	HRP
0bfd1068-3fca-a95b-e050-11ac0c4860c3	5	4	5	14	HRP	3	7	5	15	HRP
0bfd1068-3fcd-a95b-e050-11ac0c4860c3	6	6	5	17	HRP	4	12	5	21	HRP
0bfd1068-3fcf-a95b-e050-11ac0c4860c3	12	9	13	34	HRP	9	27	13	49	HRP
0bfd1068-3fd3-a95b-e050-11ac0c4860c3	9	8	27	44	HRP	6	47	27	80	HRD
0bfd1068-3fd5-a95b-e050-11ac0c4860c3	12	13	14	39	HRP	9	21	14	44	HRP
0bfd1068-3fd8-a95b-e050-11ac0c4860c3	6	14	11	31	HRP	4	27	11	42	HRP
0bfd1068-3fdd-a95b-e050-11ac0c4860c3	10	11	16	37	HRP	5	26	16	47	HRP
0bfd1068-3fdf-a95b-e050-11ac0c4860c3	20	23	23	66	HRD	20	51	23	94	HRD
0bfd1068-3fe1-a95b-e050-11ac0c4860c3	18	19	22	59	HRD	15	53	22	90	HRD
0bfd1068-3fe4-a95b-e050-11ac0c4860c3	11	12	21	44	HRP	6	27	21	54	HRD
0bfd1068-3fe6-a95b-e050-11ac0c4860c3	4	2	11	17	HRP	3	26	11	40	HRP
0bfe2ac9-0aec-c248-e050-11ac0d487e1c	4	8	7	19	HRP	3	11	7	21	HRP
0bfe2ac9-0aee-c248-e050-11ac0d487e1c	4	8	6	18	HRP	3	11	6	20	HRP
0bfe2ac9-0af3-c248-e050-11ac0d487e1c	18	16	17	51	HRP	13	43	17	73	HRD
0bfe2ac9-0af5-c248-e050-11ac0d487e1c	8	12	13	33	HRP	7	28	13	48	HRP
0bfe2ac9-0af8-c248-e050-11ac0d487e1c	8	13	14	35	HRP	7	30	14	51	HRP
0bfe2ac9-0afa-c248-e050-11ac0d487e1c	11	11	18	40	HRP	7	25	18	50	HRP
0bfe2ac9-0afd-c248-e050-11ac0d487e1c	13	11	20	44	HRP	9	26	20	55	HRD
0bfe2ac9-0aff-c248-e050-11ac0d487e1c	10	11	21	42	HRP	6	27	21	54	HRD
0bfebf9f-c779-e57d-e050-11ac0d487827	8	9	11	28	HRP	5	19	11	35	HRP
0bfebf9f-c77d-e57d-e050-11ac0d487827	17	18	25	60	HRD	15	52	25	92	HRD
0bfebf9f-c77f-e57d-e050-11ac0d487827	5	10	18	33	HRP	4	25	18	47	HRP
0bfebf9f-c781-e57d-e050-11ac0d487827	13	10	21	44	HRP	8	23	21	52	HRP
0bfebf9f-c783-e57d-e050-11ac0d487827	11	12	21	44	HRP	7	27	21	55	HRD
0c0038ff-6cc4-b0b0-e050-11ac0d483d73	9	11	13	33	HRP	8	29	13	50	HRP
0c0038ff-6cc6-b0b0-e050-11ac0d483d73	8	12	13	33	HRP	7	28	13	48	HRP
0c0038ff-6cc8-b0b0-e050-11ac0d483d73	11	18	22	51	HRP	7	36	22	65	HRD
0c18a8b7-bad1-4aa4-a6df-472f89d9761c	0	0	0	0	HRP	0	0	0	0	HRP
0c39c03a-ec84-42c6-be69-8e98bc7a9f5a	19	5	23	47	HRP	10	19	23	52	HRP
0c7aca3f-e006-4de3-afc2-20b4f727d4fd	23	11	20	54	HRD	13	24	20	57	HRD
0c8f7e63-7a3e-42e8-9408-c5cbd2f52f9d	0	0	0	0	HRP	0	0	0	0	HRP
0c9a5dbc-f7f3-43e7-83d1-77b9fb4b8b54	1	0	0	1	HRP	1	2	0	3	HRP
0cb4356c-b5d6-4541-b048-ff6d4b3a5d26	1	2	0	3	HRP	0	2	0	2	HRP
0cd60b96-eb2d-4687-9709-d1455ec45de7	11	7	16	34	HRP	8	15	16	39	HRP
0cdbabf2-c623-11e3-bf01-24c6515278c0	7	4	12	23	HRP	5	6	12	23	HRP
0ce6f3ed-bdbc-4b70-9db4-2e48f4bf644d	0	0	0	0	HRP	0	0	0	0	HRP
0cf9bbc2-cbd5-4b64-8d90-cfa416307b39	2	6	17	25	HRP	1	7	17	25	HRP
0d0793c1-df1b-4db1-ba36-adcb960cc0f5	39	29	32	100	HRD	37	60	32	129	HRD
0d259ac2-03d1-4814-9b0b-d05e3a6029b7	5	5	5	15	HRP	2	10	5	17	HRP
0d31a44f-1fc5-43a2-9633-36c4e650d3d2	5	2	5	12	HRP	3	2	5	10	HRP
0d569bd5-418d-4d72-87ca-8e14668c2119	1	2	4	7	HRP	0	3	4	7	HRP
0db9309e-7b95-4ae3-b0ed-dfd4f38d11b0	4	2	8	14	HRP	2	6	8	16	HRP
0dd0718d-5ddf-4c59-8c47-0f51303daeb5	4	8	8	20	HRP	1	8	8	17	HRP
0dd39eca-c623-11e3-bf01-24c6515278c0	7	6	12	25	HRP	2	11	12	25	HRP
0e1e628b-823a-4861-aa95-bed2fada7349	0	0	0	0	HRP	0	0	0	0	HRP
0e54cea2-d568-4a33-b9db-b698844e6ad9	15	10	17	42	HRP	10	26	17	53	HRD
0e6654c9-cd5e-4f94-a6d4-54f2bb16de1f	11	6	23	40	HRP	7	16	23	46	HRP
0e6ca8dc-0f31-4675-95b1-5920576daeff	2	2	6	10	HRP	1	7	6	14	HRP
0e7ac212-0469-4f17-9432-205ab1831257	5	5	9	19	HRP	4	8	9	21	HRP
0e7f46ca-6f5c-4538-b6d6-00af65d57fcf	5	7	5	17	HRP	2	9	5	16	HRP
0e872e0d-4711-4364-a5d0-6beeb6fd3ff2	1	4	20	25	HRP	1	17	20	38	HRP
0ead45d8-d785-4404-8319-2ef951e02e03	44	17	30	91	HRD	41	38	30	109	HRD
0ed2e2e1-2fe3-43eb-8cad-34f3f21a7169	1	2	0	3	HRP	1	2	0	3	HRP
0ed63d84-d3fe-4289-9255-35f4a03b703b	0	0	0	0	HRP	0	0	0	0	HRP
0eeafcd6-c623-11e3-bf01-24c6515278c0	4	10	12	26	HRP	3	14	12	29	HRP
0ef92ff8-829f-425a-91d8-c594b6e22a2b	19	14	20	53	HRP	13	16	20	49	HRP
0efb6e20-236d-4640-9373-6fc03e67d090	0	0	0	0	HRP	0	0	0	0	HRP
0efee3f3-313b-44eb-b3b0-af975a1ded82	7	5	4	16	HRP	2	6	4	12	HRP
0f53e757-1823-409f-a0ea-249270728e15	2	1	1	4	HRP	1	3	1	5	HRP
0f6b355e-3898-4be6-be97-da0c3840a4ed	4	3	10	17	HRP	3	5	10	18	HRP
0f9e70b3-24cf-4d76-af7b-84ace66ec5a7	14	7	20	41	HRP	10	17	20	47	HRP
0fa9cfba-0f49-47d0-ab54-9dd2144e0a73	3	0	2	5	HRP	3	5	2	10	HRP
0fbd94b1-bb34-4620-841b-861a0b5e0c12	2	6	11	19	HRP	2	9	11	22	HRP
0fc63b79-7fff-441d-88fc-922d53c787ab	9	7	25	41	HRP	6	18	25	49	HRP
10136472-c623-11e3-bf01-24c6515278c0	1	0	1	2	HRP	1	0	1	2	HRP
1021b60d-f7b2-43b0-b2cc-f282d619d533	38	9	23	70	HRD	35	28	23	86	HRD
105a51c4-cc7e-4d0f-9cf8-e4d64a31d14d	16	6	13	35	HRP	14	10	13	37	HRP
108749d2-5c62-4ef1-92df-aec6941ba53b	3	1	2	6	HRP	2	2	2	6	HRP
108b67d4-5d66-46da-8675-6acae643b76f	3	2	1	6	HRP	2	3	1	6	HRP
10ad692b-4c3d-42de-9b5e-4968441388b3	3	3	4	10	HRP	3	3	4	10	HRP
10bb1a92-901e-4a14-80f4-5e88f997754b	4	6	11	21	HRP	3	13	11	27	HRP
10cb8ac6-c622-11e3-bf01-24c6515278c0	5	4	14	23	HRP	3	13	14	30	HRP
10d15b7a-16d1-4953-aaef-f193ffa97f42	1	3	10	14	HRP	1	4	10	15	HRP
10db2142-c623-11e3-bf01-24c6515278c0	2	0	7	9	HRP	1	4	7	12	HRP
110b5f05-ded7-45ec-b0f6-a941c92d77dd	30	9	30	69	HRD	26	64	30	120	HRD
1127b561-ea40-4d5e-95df-daa0a5ebc1e4	0	1	2	3	HRP	0	2	2	4	HRP
11473a98-d953-45f9-abf5-709b68a4bae8	5	8	9	22	HRP	5	13	9	27	HRP
1157a548-6770-4c89-a84c-bcf6f0e96ea8	1	0	2	3	HRP	1	0	2	3	HRP
1168944c-5451-4a18-8758-88bf5723bdd9	19	16	18	53	HRP	16	24	18	58	HRD
1193a9c4-5aab-4cd7-a690-60c96bd1172d	1	0	1	2	HRP	0	2	1	3	HRP
11ae45fb-05f6-425a-9295-d50d13407006	0	0	0	0	HRP	0	0	0	0	HRP
120f01d1-8884-4aca-a1cb-36b207b2aa3a	11	6	4	21	HRP	9	14	4	27	HRP
122bf0a9-8052-49da-a9d7-0e5de9ab7032	1	4	0	5	HRP	1	4	0	5	HRP
123c9d1c-72ba-4d82-8e57-d5caa52a40ba	11	4	14	29	HRP	10	11	14	35	HRP
124d5b04-4588-44c3-9c00-61e064cf1bdb	13	6	14	33	HRP	11	19	14	44	HRP
126ee433-d345-4cac-882a-c91831a24690	0	1	0	1	HRP	0	5	0	5	HRP
127b0f7d-d24e-48b7-ac25-d3f14a43952d	31	18	28	77	HRD	22	38	28	88	HRD
12874085-a596-41ae-b4cd-817cb1ebb278	11	8	15	34	HRP	8	16	15	39	HRP
1292e13b-d7c6-447b-a227-9a8113215580	16	23	32	71	HRD	11	57	32	100	HRD
129459c1-38be-45da-bb87-18848c97c544	19	6	11	36	HRP	14	20	11	45	HRP
1295947c-c623-11e3-bf01-24c6515278c0	2	2	2	6	HRP	2	2	2	6	HRP
129d2c6c-6688-4b29-bfa7-8df3fe77b25a	0	0	0	0	HRP	0	0	0	0	HRP
129de5b2-d9b0-4762-9ef8-72d98231fb50	25	11	11	47	HRP	21	19	11	51	HRP
12ae2ba1-9484-47fe-8a3f-bba94a6abe0c	0	0	0	0	HRP	0	0	0	0	HRP
12d7121a-0345-4808-a819-09d6e3227bd5	1	1	2	4	HRP	1	1	2	4	HRP
12f038e1-00af-4c64-a2e0-9e63323492ef	12	8	16	36	HRP	8	33	16	57	HRD
12f1ae2f-2666-45be-9742-f502d212373d	3	3	5	11	HRP	3	3	5	11	HRP
131332b2-ff51-4bd7-a626-aff2ecea6135	4	2	2	8	HRP	3	3	2	8	HRP
1327bbd4-a466-4e26-905f-cf91315f1cc8	1	8	8	17	HRP	1	11	8	20	HRP
132f7f2a-b902-4343-aa08-cf6a7af10b9a	0	0	2	2	HRP	0	1	2	3	HRP
13446fc4-9fa6-4bb3-a00a-b9265b41eb12	1	0	1	2	HRP	1	0	1	2	HRP
134c9a92-e91e-4347-a9c4-727279edebb1	11	5	9	25	HRP	5	10	9	24	HRP
1358ff92-4db9-4e42-b63a-984a7bea425a	0	0	0	0	HRP	0	0	0	0	HRP
13642cf8-9840-4a7d-a26a-95f65b2c70c3	0	0	0	0	HRP	0	0	0	0	HRP
13bd2b30-c623-11e3-bf01-24c6515278c0	8	4	6	18	HRP	5	7	6	18	HRP
13c312ec-0add-4758-ab8d-c193e2e08c6d	1	6	7	14	HRP	1	6	7	14	HRP
13c62975-9f5e-4d40-a461-dceab08a31ec	4	6	5	15	HRP	2	12	5	19	HRP
13c7065e-6780-4571-978e-a7c13078ff50	4	3	7	14	HRP	2	5	7	14	HRP
13d05f7a-e16a-40ef-9a15-21257da2cf89	4	1	4	9	HRP	2	4	4	10	HRP
140d5fa9-afbe-444e-a7e7-6a4cb4ab2923	3	4	11	18	HRP	3	5	11	19	HRP
140d6ef7-0217-4d16-9add-215d0d14ba06	0	0	4	4	HRP	0	0	4	4	HRP
141918cd-3e23-45bc-96e1-b208c80f69e7	0	0	2	2	HRP	0	1	2	3	HRP
142b6dbf-c943-4a7d-8ab6-13a975f48d7a	11	8	12	31	HRP	6	12	12	30	HRP
14334aea-2dae-428c-9d4a-1a37878dfc3f	6	3	7	16	HRP	3	11	7	21	HRP
1447c8cb-25d4-4092-8919-4df08f898d2d	3	2	7	12	HRP	1	3	7	11	HRP
145f2b89-8878-4390-b0f6-f09b02fb138a	5	10	8	23	HRP	2	15	8	25	HRP
145f6dbb-9744-44f7-8485-e440689de3fd	3	4	6	13	HRP	3	4	6	13	HRP
14630c19-9ee0-4ab3-9d8b-8c3309d1e7d0	9	9	15	33	HRP	5	16	15	36	HRP
147e3496-514e-4da7-be42-7cd9be78ed04	0	0	0	0	HRP	0	0	0	0	HRP
148536ce-ee2a-4952-a19d-10d6f44146b9	1	0	0	1	HRP	1	0	0	1	HRP
1494bb16-f1f0-42a4-b10e-c383574cbc8b	0	0	2	2	HRP	0	1	2	3	HRP
14b8bbf2-310b-459b-b52d-a7ef510ce1cf	9	5	11	25	HRP	5	16	11	32	HRP
14bf9bfb-14d6-4cac-a556-828f680e8a15	13	11	21	45	HRP	9	31	21	61	HRD
14c5b81d-da49-4db1-9834-77711c2b1d38	5	2	7	14	HRP	5	4	7	16	HRP
14cbcbb1-028b-471a-bb4f-8b29cfa5e4eb	0	0	0	0	HRP	0	0	0	0	HRP
14dd86c1-dfb3-4124-a453-4d64223bc048	1	1	2	4	HRP	1	1	2	4	HRP
14ed7388-41ed-43d4-afb2-04cd6410d5d2	9	4	18	31	HRP	5	9	18	32	HRP
14f41457-25c3-4979-8515-4f33322039a5	0	0	0	0	HRP	0	0	0	0	HRP
153a64ee-6322-4f2e-b3df-77ef7d3a4cf0	13	13	21	47	HRP	10	22	21	53	HRD
154f80bd-984c-4792-bb89-20c4da0c08e0	0	0	1	1	HRP	0	0	1	1	HRP
15563a10-47a8-401d-a507-2c7101f7ae60	0	0	0	0	HRP	0	0	0	0	HRP
1558629a-770a-4dcb-b0bf-9a8bcea9d80b	8	5	5	18	HRP	6	12	5	23	HRP
155873b2-e5de-405f-87f6-6de0d238b160	2	3	2	7	HRP	0	3	2	5	HRP
15678c3d-ce61-454d-849e-1d4ca358909b	3	6	5	14	HRP	1	12	5	18	HRP
15895218-c623-11e3-bf01-24c6515278c0	3	4	10	17	HRP	2	10	10	22	HRP
15a93657-0521-430a-a816-bf0842374b75	1	2	2	5	HRP	0	2	2	4	HRP
15abb2a3-10a2-4e04-8eb9-6eadbd976af0	0	0	0	0	HRP	0	0	0	0	HRP
15d597de-d26c-4ce1-b0cb-077e39b55f30	16	12	21	49	HRP	12	23	21	56	HRD
15daadb0-6b24-4248-9225-470dc08f1552	2	3	9	14	HRP	1	6	9	16	HRP
15dd024e-c0da-461a-84db-d01e60a22210	0	2	0	2	HRP	0	2	0	2	HRP
15e097e3-e468-466c-8e57-b59fba90bbf2	1	1	1	3	HRP	1	1	1	3	HRP
15e7d981-8c27-4b2b-b4f8-626e22021895	17	16	23	56	HRD	12	25	23	60	HRD
15f90ef0-831b-40a3-98bd-ec226a9e8b26	12	9	12	33	HRP	9	19	12	40	HRP
15fd8dc8-c622-11e3-bf01-24c6515278c0	4	2	7	13	HRP	2	2	7	11	HRP
1659bae5-3140-4d05-891c-81b48277b2fc	18	9	17	44	HRP	13	25	17	55	HRD
16c6f975-48fd-4cda-946a-777cb922949d	3	2	2	7	HRP	3	10	2	15	HRP
16d33e09-2e21-4da2-8e57-e78ce28c4408	31	7	25	63	HRD	23	30	25	78	HRD
16d5519e-ecb9-4fc8-81f1-e0e4adf722a8	8	8	22	38	HRP	5	14	22	41	HRP
16df7888-2480-4394-8856-d57a6ef371d2	7	2	15	24	HRP	3	9	15	27	HRP
170ad241-9e24-469b-b7ca-3fd783a89b21	12	7	19	38	HRP	11	14	19	44	HRP
1727e88b-df0a-4af2-9191-8c6061d98ad0	5	2	15	22	HRP	2	7	15	24	HRP
172c9864-c26d-4e9b-947a-e8ce761e996d	1	4	6	11	HRP	1	7	6	14	HRP
1776f326-b12f-4355-8107-80fa6fcd2159	10	4	7	21	HRP	8	5	7	20	HRP
178d0486-cb0d-4979-8bdf-bb3fe99149bd	0	0	0	0	HRP	0	0	0	0	HRP
17a66d24-de77-4f2a-a8ad-d2c6a69e7671	0	0	0	0	HRP	0	0	0	0	HRP
17de5b12-c623-11e3-bf01-24c6515278c0	10	3	10	23	HRP	9	14	10	33	HRP
17ed8831-a261-42d9-8ff3-cf75a6cb2a24	16	4	20	40	HRP	12	18	20	50	HRP
183b04f5-107f-496c-8e9a-8263dd00cffa	11	10	14	35	HRP	5	14	14	33	HRP
186cacaf-4f20-4ad2-a07a-a7dc942a70b0	4	2	0	6	HRP	4	6	0	10	HRP
18ec066e-8510-4921-9e35-45d85fb01e38	1	0	4	5	HRP	0	2	4	6	HRP
18f5e75e-c623-11e3-bf01-24c6515278c0	5	0	8	13	HRP	3	1	8	12	HRP
18f9240e-7acd-41eb-a154-c2a67a1cbe9b	0	5	6	11	HRP	0	6	6	12	HRP
19085f7d-e6a6-406f-bd09-520a27e0283d	2	3	4	9	HRP	1	4	4	9	HRP
190eb791-383d-4e27-870d-e470630843e7	6	6	19	31	HRP	4	18	19	41	HRP
19233fd1-5229-466e-acf3-5882165758e0	0	0	0	0	HRP	0	0	0	0	HRP
1924d200-6929-4eef-8a7f-317f8fbab915	0	1	1	2	HRP	0	1	1	2	HRP
199bbb0f-996c-40c1-b06d-2066f04be778	1	2	4	7	HRP	1	3	4	8	HRP
19aa8223-ee84-4b5c-b11a-6ca2a2680b3c	1	2	2	5	HRP	0	4	2	6	HRP
19b6b9d6-6912-4b85-a4bf-52014bcb170b	1	0	3	4	HRP	1	2	3	6	HRP
19c1c97f-a3ec-44a8-8a20-6f97caed1a4f	2	0	4	6	HRP	2	1	4	7	HRP
19cd4360-8392-4bc2-ae88-fdc1335d886b	1	2	0	3	HRP	1	2	0	3	HRP
19d6cf34-1cd7-4242-a4d1-5d3e11f428aa	1	0	0	1	HRP	0	0	0	0	HRP
19def402-fb8d-4b27-90dd-ce9135a3c0a2	0	1	1	2	HRP	0	1	1	2	HRP
19fe27d8-c623-11e3-bf01-24c6515278c0	6	5	7	18	HRP	5	6	7	18	HRP
1a0ef226-41a5-4b56-9078-4b7834f0c976	4	4	17	25	HRP	4	14	17	35	HRP
1a134c18-ced3-4bae-9f15-5f0f09526639	0	0	0	0	HRP	0	0	0	0	HRP
1a319682-f55e-4e0b-8476-48a0bea6c265	3	2	0	5	HRP	1	3	0	4	HRP
1a391468-fbf3-451a-b88e-a257a26d047f	28	15	27	70	HRD	23	38	27	88	HRD
1a4633c4-72a0-4e30-8c4c-345e04337627	2	2	7	11	HRP	2	10	7	19	HRP
1a5bf97e-3d49-4d3f-b385-ffa7a295be9c	0	0	0	0	HRP	0	2	0	2	HRP
1a841850-fca0-48ab-8c78-db0bd5a64435	12	5	15	32	HRP	7	11	15	33	HRP
1ac15380-04a2-42dd-8ade-28556a570e80	14	6	10	30	HRP	10	9	10	29	HRP
1ac54c6e-a1e4-4f3b-b4a5-cdb327e0dca6	7	1	10	18	HRP	6	9	10	25	HRP
1aff91a6-1b0f-4575-8f4b-4e064a50b886	7	8	22	37	HRP	6	13	22	41	HRP
1b06afe2-c623-11e3-bf01-24c6515278c0	5	0	8	13	HRP	4	2	8	14	HRP
1b0fe1d5-b286-4f49-ae92-94d9c6db9657	2	3	0	5	HRP	2	4	0	6	HRP
1b1780d5-06da-40ee-9e15-02631a68027b	6	4	5	15	HRP	5	12	5	22	HRP
1b7838c9-c685-41c3-b184-a2e40c7c4dc7	3	0	2	5	HRP	1	0	2	3	HRP
1b8fe07d-859c-4d91-ade1-6b2bcb5774ce	0	0	1	1	HRP	0	2	1	3	HRP
1bb2bdb7-8a89-4e7d-903d-03a6f8018efb	9	1	11	21	HRP	7	5	11	23	HRP
1bb3a1c7-4d7b-4fb6-b54d-e94cbd0e32aa	24	10	13	47	HRP	22	47	13	82	HRD
1bbb522d-e224-4b3f-9e10-3a47d06b2b05	0	0	0	0	HRP	0	0	0	0	HRP
1bbfe6f2-ad19-4d29-895b-973f5a91c707	5	2	0	7	HRP	3	19	0	22	HRP
1bd47e40-d708-4ca2-b4b3-eb8d996c916b	0	0	0	0	HRP	0	0	0	0	HRP
1bd74f92-47f6-427e-af6f-299c3a7fe023	1	0	1	2	HRP	1	0	1	2	HRP
1bdfaa8a-1b7e-4251-b135-ce5e4568371b	1	3	2	6	HRP	1	3	2	6	HRP
1be81ade-7ad6-4e7e-90d0-f986b3fb0a25	0	1	0	1	HRP	0	5	0	5	HRP
1be8fa2c-8fea-4e8c-90db-c04d9fcdbf49	16	9	18	43	HRP	8	27	18	53	HRD
1bea3a72-3b73-4072-a6bb-96a90119d3ac	2	0	4	6	HRP	1	0	4	5	HRP
1c00925b-7328-4db0-b930-04aab2d80719	5	9	15	29	HRP	2	19	15	36	HRP
1c0e384f-7254-4afe-93c0-b3fc6c6a7894	11	8	29	48	HRP	7	27	29	63	HRD
1c10ab52-01a3-11e4-8395-af1f6b7ba88c	0	4	5	9	HRP	0	6	5	11	HRP
1c188bf5-2c99-4eb4-a774-59c75d53e643	14	12	26	52	HRP	13	50	26	89	HRD
1c1c6494-c623-11e3-bf01-24c6515278c0	5	2	4	11	HRP	2	4	4	10	HRP
1c28e44a-6e6c-44ed-b58a-e3262c0e6759	5	3	10	18	HRP	4	9	10	23	HRP
1c300960-e51c-4477-8fdd-026c7e545dc4	0	0	0	0	HRP	0	0	0	0	HRP
1c3df485-8e75-4378-87f6-c6463a520624	16	10	21	47	HRP	8	22	21	51	HRP
1c9fbe26-1447-4335-aaab-06d6bb3e2741	12	4	18	34	HRP	8	13	18	39	HRP
1cb25b72-3726-4f12-9e22-f5c7e4b05681	1	3	5	9	HRP	1	3	5	9	HRP
1cd0acf2-3116-4dfa-a063-0a435b9f6da3	11	14	23	48	HRP	10	37	23	70	HRD
1d0617e8-2725-4411-b50f-e46ea1d43242	2	0	1	3	HRP	0	0	1	1	HRP
1d1eeba2-4d7b-4380-b0b6-26d246bc4158	1	0	1	2	HRP	0	0	1	1	HRP
1d2d355a-8409-4c8a-9f07-ac62885e228d	27	9	26	62	HRD	24	28	26	78	HRD
1d325d84-a3a0-4802-9842-76cb21cecb1c	0	2	3	5	HRP	0	2	3	5	HRP
1d4a091d-fe65-49c0-8810-5a95243b108a	8	5	11	24	HRP	6	14	11	31	HRP
1d6c9181-a02f-4c35-85b3-65dc5808f50e	7	3	4	14	HRP	4	7	4	15	HRP
1d91f9c7-67ba-4606-9f0a-01ec6fc08262	4	2	2	8	HRP	4	6	2	12	HRP
1d97ba51-d981-4986-9f71-c2b6cb9961c3	0	0	0	0	HRP	0	0	0	0	HRP
1daefc49-5248-4948-87ce-0ec19a248ef9	7	5	11	23	HRP	6	9	11	26	HRP
1db83e80-bdf7-4d8d-8008-bd8406d641fc	9	4	9	22	HRP	5	11	9	25	HRP
1dbdbb2c-c623-11e3-bf01-24c6515278c0	2	2	7	11	HRP	1	4	7	12	HRP
1dc9e7fd-fc62-4b32-9619-4e02a266a385	19	19	31	69	HRD	13	56	31	100	HRD
1dd96495-5f83-4d36-96cf-b77cd0cbbfda	0	0	0	0	HRP	0	0	0	0	HRP
1de83d45-8492-4b83-9055-a9f43b823f91	0	0	0	0	HRP	0	0	0	0	HRP
1df8939c-c622-11e3-bf01-24c6515278c0	8	11	14	33	HRP	5	15	14	34	HRP
1e046ab9-fa4c-4c15-8d78-ed0048c80ebf	0	1	3	4	HRP	0	4	3	7	HRP
1e181878-c640-4e91-a620-3fc4b08a4de1	14	14	16	44	HRP	13	20	16	49	HRP
1e27cc8a-5394-4958-9af6-5ece1fe24516	7	3	1	11	HRP	5	7	1	13	HRP
1e2dcbcc-771c-43c5-8c8d-e0eb77cb3494	19	6	19	44	HRP	17	20	19	56	HRD
1e8ae8dd-74c1-44d5-a74e-bfdce801c736	2	1	3	6	HRP	1	1	3	5	HRP
1ea7e01c-c623-11e3-bf01-24c6515278c0	10	7	11	28	HRP	6	12	11	29	HRP
1eb1bc62-18f6-4bcb-a16d-aa6a91914031	4	1	0	5	HRP	3	4	0	7	HRP
1eb37b28-fac2-477a-88b3-e04291a07926	1	4	5	10	HRP	1	7	5	13	HRP
1eb62abc-7928-405b-84cc-f091ca5347b2	13	13	19	45	HRP	6	26	19	51	HRP
1f04210a-0c2e-4bb8-ac8e-86198e5f1d34	1	2	1	4	HRP	1	9	1	11	HRP
1f2a8889-4374-4037-bb56-0f20733380e3	26	9	14	49	HRP	19	10	14	43	HRP
1f5e70c1-c5de-49e7-941a-46e11a4f4416	2	10	7	19	HRP	1	12	7	20	HRP
1f81a1b0-8089-44ef-87b5-b3359a407ad2	6	6	15	27	HRP	5	16	15	36	HRP
1f8d8720-30ca-4057-90f7-a34b8383eafe	0	0	0	0	HRP	0	0	0	0	HRP
1f967003-82d6-4932-a445-24fc25723594	12	5	12	29	HRP	10	10	12	32	HRP
1fd69adc-c623-11e3-bf01-24c6515278c0	3	2	2	7	HRP	1	4	2	7	HRP
1fdab6a6-7346-4229-aa8d-5dbd258f0c60	8	6	22	36	HRP	6	12	22	40	HRP
1ff155dd-deb4-44e0-b3a2-e4875b618435	11	6	10	27	HRP	9	10	10	29	HRP
1fff8b62-534b-4d71-a65f-e5f93b8b50ed	14	3	15	32	HRP	9	14	15	38	HRP
2009e5e7-1796-445b-8677-46b3804fe0bf	5	4	6	15	HRP	3	7	6	16	HRP
2045c788-9ea8-4ea5-a5e3-65fc16a62adb	24	11	28	63	HRD	15	44	28	87	HRD
207f8a42-5b05-4876-b0ae-ebfaeea27844	38	19	30	87	HRD	30	66	30	126	HRD
209a9b10-7129-48fe-a899-d14ba17efe6f	1	3	5	9	HRP	0	4	5	9	HRP
20d1b88b-3ff6-4201-a748-6a993500c652	5	0	0	5	HRP	3	0	0	3	HRP
20e02396-e676-412d-9724-44a428919cdb	22	11	24	57	HRD	17	21	24	62	HRD
2102558b-87b0-447b-bb9a-e4ae9df8b75e	18	5	10	33	HRP	11	11	10	32	HRP
2109e1d4-c623-11e3-bf01-24c6515278c0	9	6	5	20	HRP	7	10	5	22	HRP
21205681-a0c7-48d0-81d4-0b7ef31158cf	15	10	24	49	HRP	8	15	24	47	HRP
2182ce2c-5941-4b65-9419-fc7966d5e6d5	1	2	0	3	HRP	1	2	0	3	HRP
21b1a37f-e91e-4ce1-83cf-bb89b8d0fb35	10	1	7	18	HRP	9	2	7	18	HRP
21e7e43e-f9b1-4351-a6d9-b9cd06d15f68	0	0	0	0	HRP	0	2	0	2	HRP
221d0290-c623-11e3-bf01-24c6515278c0	4	6	8	18	HRP	3	9	8	20	HRP
22578b9f-78dc-464c-9bb9-382f033283d0	1	1	3	5	HRP	1	2	3	6	HRP
228fb827-c05e-494c-8a21-e1d925e100cb	5	2	6	13	HRP	4	7	6	17	HRP
2290b078-6a5b-4c83-9dfb-b525bbf14e4e	15	12	17	44	HRP	11	19	17	47	HRP
22cd3875-a123-4f0d-8cd1-371958208ad6	0	0	1	1	HRP	0	0	1	1	HRP
22d67778-61fc-4f15-95b8-7e7c6cc7112b	1	5	6	12	HRP	1	7	6	14	HRP
22edd867-dcd6-42b5-92bb-025ceb84b106	4	2	9	15	HRP	1	6	9	16	HRP
230f53ef-be3f-495e-9b95-b0f670bd6908	0	0	0	0	HRP	0	0	0	0	HRP
2316ee90-c623-11e3-bf01-24c6515278c0	1	1	1	3	HRP	1	2	1	4	HRP
2321c412-7730-4694-bc8f-199d7e51a7f8	1	0	1	2	HRP	1	0	1	2	HRP
232b7754-b3c3-4530-9d24-3af40d9b2816	5	0	7	12	HRP	4	4	7	15	HRP
2399ab13-abfa-480e-9fda-7947edc420be	5	7	5	17	HRP	4	13	5	22	HRP
23cc70c4-b744-4fa0-a0de-b25c0fdf212f	0	0	0	0	HRP	0	0	0	0	HRP
23d77176-dfed-4bee-ac96-9934377d8d81	3	12	36	51	HRP	3	69	36	108	HRD
23d86395-9e20-4cf9-bf7e-f76544a1f772	1	1	6	8	HRP	1	7	6	14	HRP
23eb72d8-c622-11e3-bf01-24c6515278c0	1	1	3	5	HRP	0	1	3	4	HRP
23fa90d5-b273-4e2c-9c88-68aa57b60e97	0	0	0	0	HRP	0	0	0	0	HRP
241abdfd-e6de-4830-a233-4bbc5f622725	14	6	10	30	HRP	9	9	10	28	HRP
2425a532-f562-423a-88f5-228642f53875	1	1	3	5	HRP	1	1	3	5	HRP
2439ec74-1713-4d47-a5d9-886f69dddcb6	5	0	2	7	HRP	3	3	2	8	HRP
2468e58c-c623-11e3-bf01-24c6515278c0	14	4	21	39	HRP	10	10	21	41	HRP
248fd0ed-f14c-40b8-9f14-e9c7adf16e22	0	0	0	0	HRP	0	0	0	0	HRP
24badf07-8615-48a3-8d6e-45c3d783f18d	1	2	4	7	HRP	1	8	4	13	HRP
24f887e1-ce82-40f3-9674-11102bd076c0	1	0	0	1	HRP	0	0	0	0	HRP
25103371-28ac-4f43-b0e2-2d376d0dcb84	8	3	10	21	HRP	5	7	10	22	HRP
25224aa0-cfdd-48ec-92e5-8f3992a3e574	11	9	22	42	HRP	11	48	22	81	HRD
252a1c43-f954-44d7-8e31-6bcd0157a05c	0	2	2	4	HRP	0	2	2	4	HRP
2564a262-03e8-467b-9ea2-f3ab38d75ae1	8	1	7	16	HRP	5	13	7	25	HRP
2572b0bc-c622-11e3-bf01-24c6515278c0	2	3	7	12	HRP	1	7	7	15	HRP
2584b428-c623-11e3-bf01-24c6515278c0	7	6	19	32	HRP	5	19	19	43	HRP
25bee010-cc99-4af0-ba2f-fe4dd308be33	2	0	3	5	HRP	1	2	3	6	HRP
25c002f7-e972-421a-b32d-7dd675d81931	0	0	0	0	HRP	0	0	0	0	HRP
25c32aca-6738-43ef-a103-243f2f9a3b43	15	10	13	38	HRP	12	19	13	44	HRP
25c76a8f-77c0-4650-bddf-45ed0c10a2e6	15	22	22	59	HRD	12	38	22	72	HRD
25c99312-bf63-4654-a73a-03c3c1cd50b6	0	0	1	1	HRP	0	3	1	4	HRP
25cf7449-8c5b-403e-aa75-e2af158598e8	11	5	8	24	HRP	10	10	8	28	HRP
25e20393-752b-4796-9001-0e22ee04c586	2	1	2	5	HRP	2	2	2	6	HRP
25e4cad7-2403-4992-9cbc-433574673549	8	1	7	16	HRP	4	2	7	13	HRP
25e68b09-7d62-4449-a14a-8d09edd96db6	0	0	0	0	HRP	0	0	0	0	HRP
25f07374-313a-4100-9a60-3d21d2988fca	27	14	14	55	HRD	20	24	14	58	HRD
25f73b03-4ba8-47ba-ad80-6ccb82105c98	8	4	15	27	HRP	4	14	15	33	HRP
2660825c-68f0-4631-948e-6da158edbe9e	2	2	2	6	HRP	1	2	2	5	HRP
267a9862-17bd-4056-ba4a-1f373736ffbb	3	2	6	11	HRP	0	4	6	10	HRP
26c301a6-a597-4c24-9f6c-2293e5ae41c7	1	0	3	4	HRP	1	0	3	4	HRP
26de406e-c623-11e3-bf01-24c6515278c0	3	2	6	11	HRP	3	4	6	13	HRP
274723ac-2bc1-4e2c-b31a-1907217b9f84	0	0	1	1	HRP	0	0	1	1	HRP
27847313-3b1e-47f2-84f1-acadaf265cf3	2	9	10	21	HRP	2	12	10	24	HRP
278b2498-1d64-493b-ac43-3489ec86f313	1	0	2	3	HRP	1	0	2	3	HRP
2790b964-63e3-49aa-bf8c-9a00d3448c25	9	7	9	25	HRP	8	8	9	25	HRP
27b56bf2-7a9d-4061-98d4-61fe2761578c	5	6	8	19	HRP	4	12	8	24	HRP
27f87d1e-2c32-4beb-9677-62f7a286673d	13	10	26	49	HRP	10	39	26	75	HRD
27fcccdc-c622-11e3-bf01-24c6515278c0	3	2	3	8	HRP	3	3	3	9	HRP
280a069c-38e5-4300-a15c-2612301b70e3	4	2	2	8	HRP	1	7	2	10	HRP
2828e5e6-c623-11e3-bf01-24c6515278c0	1	3	4	8	HRP	0	6	4	10	HRP
282b45ee-4af2-4c61-9acc-286eaf8d661a	13	9	16	38	HRP	9	17	16	42	HRP
28839c75-90a8-493f-b658-8c63e0ebd324	18	8	17	43	HRP	13	17	17	47	HRP
289790a5-77bd-49a9-a1ec-478a8ecacd7f	2	3	3	8	HRP	1	6	3	10	HRP
28e81540-4744-4865-b627-c7c9d8a3c2b8	7	18	20	45	HRP	5	31	20	56	HRD
28f41a20-b6d6-4ecc-888f-72f779ad9af7	5	4	2	11	HRP	2	5	2	9	HRP
28f8d45f-4763-472e-9c4d-6787ba00164b	1	0	1	2	HRP	1	1	1	3	HRP
29127cde-548f-4c42-96cf-6f0020c3db9a	1	2	0	3	HRP	1	8	0	9	HRP
293a2f0a-4846-4c7c-b8b1-bb741c8d3275	8	1	9	18	HRP	4	10	9	23	HRP
29548b5f-c88a-4908-8c46-e86483e75067	4	2	10	16	HRP	3	4	10	17	HRP
29578759-9ccb-4a24-b5b8-c45ebd4339d9	1	0	1	2	HRP	1	0	1	2	HRP
295aac88-c623-11e3-bf01-24c6515278c0	17	10	19	46	HRP	14	18	19	51	HRP
29a00d78-b9bb-4c6b-b142-d5b8bfa63455	9	3	8	20	HRP	6	7	8	21	HRP
29b92b51-7ba3-42a9-97d3-6a9b5e43f928	13	7	14	34	HRP	8	13	14	35	HRP
29fc38aa-f367-46a3-a14d-a5f657ad0caa	3	4	2	9	HRP	0	7	2	9	HRP
2a5a5840-a834-47a1-b1f4-dc8fed620f5c	0	0	0	0	HRP	0	0	0	0	HRP
2a7f6aac-8f94-4815-8b94-0ea7db71135c	1	2	0	3	HRP	1	2	0	3	HRP
2a8d63eb-0174-4213-9214-413f391f512c	26	10	17	53	HRP	21	25	17	63	HRD
2abe2e53-ad9b-4fbc-b9a7-93444f1bea87	0	2	0	2	HRP	0	2	0	2	HRP
2aeaab9f-4459-4be8-91e7-e0746cbd671c	4	5	8	17	HRP	2	8	8	18	HRP
2b000af3-2c9d-4eaa-af3f-8101b7425c37	20	7	19	46	HRP	14	17	19	50	HRP
2b02e3ad-4423-491e-993a-561e80dc7bcf	1	2	0	3	HRP	0	4	0	4	HRP
2b142863-b963-4cc9-8f8f-c72503c93390	12	11	18	41	HRP	8	36	18	62	HRD
2b36ac4b-eed3-4591-8b4f-b44049dfc5ed	1	1	2	4	HRP	0	1	2	3	HRP
2b3837b3-ee29-4a08-848e-1206404da986	6	1	9	16	HRP	6	5	9	20	HRP
2b40a733-7a63-4bb8-a953-95a4ee28f962	19	17	23	59	HRD	11	32	23	66	HRD
2b41746a-95c0-4875-afb5-c6d3d3ad30d9	8	6	12	26	HRP	5	17	12	34	HRP
2b4feb84-89e4-4c38-8561-5ffab02c8132	16	15	16	47	HRP	14	26	16	56	HRD
2b54d668-7585-4bf4-9fdd-aea3c5cd4fa4	3	3	4	10	HRP	2	8	4	14	HRP
2b569b88-c622-11e3-bf01-24c6515278c0	7	5	6	18	HRP	6	11	6	23	HRP
2b6d4d66-7f0b-4bc0-b3d6-171956a937c5	10	3	6	19	HRP	9	7	6	22	HRP
2b78de4e-4c8b-4adf-a058-3dae797e7881	31	10	24	65	HRD	28	39	24	91	HRD
2bd56bba-c623-11e3-bf01-24c6515278c0	13	6	13	32	HRP	7	9	13	29	HRP
2bd9ccca-3fae-4b66-a762-6f30d6276222	10	2	11	23	HRP	6	10	11	27	HRP
2bde43e2-fd4e-413e-adc7-c50bca75d358	4	2	13	19	HRP	2	10	13	25	HRP
2bf5b018-9f19-4fbd-9e1f-7d958aabe5d1	25	14	26	65	HRD	21	60	26	107	HRD
2bff30d5-be79-4686-8164-7a7d9619d3c0	8	9	16	33	HRP	7	27	16	50	HRP
2c2e5f87-bd22-4a5e-be71-3bcc2aefaf74	0	0	0	0	HRP	0	0	0	0	HRP
2c316b7e-6a82-4ba1-9f34-d8bfcf82d41e	5	6	8	19	HRP	4	8	8	20	HRP
2c3ada8b-9650-4859-9857-43209c0f7cea	0	2	3	5	HRP	0	4	3	7	HRP
2c48eefe-2a08-47bf-8e4d-cbaab6777150	14	5	12	31	HRP	13	17	12	42	HRP
2c581a74-7716-4c20-b366-a8e1d9a901f6	6	4	3	13	HRP	4	5	3	12	HRP
2c6f1862-bb82-4e7e-9cb3-338bdf022ff4	4	3	9	16	HRP	2	4	9	15	HRP
2c71d542-1653-4d97-8752-f2fd05c7e75d	2	1	1	4	HRP	1	5	1	7	HRP
2c9c50ff-01d9-4703-931b-04119178706f	2	1	2	5	HRP	1	9	2	12	HRP
2c9dc04b-e9ec-4cf1-ab2c-a18edb30dd37	22	22	23	67	HRD	16	49	23	88	HRD
2ccd028d-e7e0-4f77-a512-f658a31819a4	1	0	1	2	HRP	0	1	1	2	HRP
2cdc4cce-0877-4ec1-85f5-20c909912e65	2	0	4	6	HRP	1	1	4	6	HRP
2ce48f01-2f61-49d9-a56a-7438bf4a37d7	0	2	1	3	HRP	0	2	1	3	HRP
2d0e4b82-c623-11e3-bf01-24c6515278c0	4	1	2	7	HRP	2	2	2	6	HRP
2da2b745-068d-408c-9163-3b3a78d4aaed	1	1	4	6	HRP	0	2	4	6	HRP
2dd5eea1-42a1-4e8b-99ac-20399cc7e15c	0	0	0	0	HRP	0	0	0	0	HRP
2deb8f9a-9e0a-46d1-bcb5-902db3b5c8ac	5	4	7	16	HRP	4	6	7	17	HRP
2df02f2b-9f1c-4249-b3b4-b03079cd97d9	0	0	1	1	HRP	0	0	1	1	HRP
2df17728-33e8-45ab-833b-ef68a5482daa	0	0	0	0	HRP	0	0	0	0	HRP
2dfe70fd-2650-49c0-b6eb-67df585d063b	0	0	0	0	HRP	0	0	0	0	HRP
2e0bbaf6-c623-11e3-bf01-24c6515278c0	1	2	6	9	HRP	1	3	6	10	HRP
2e43e0ca-54ea-482e-acf2-0048d9187a5c	15	8	20	43	HRP	13	20	20	53	HRD
2e66eb75-097c-4ad8-b2b3-9f5849dfd02f	16	9	17	42	HRP	4	17	17	38	HRP
2e69c886-535b-4ff0-9236-abf6799acdbd	10	9	16	35	HRP	4	17	16	37	HRP
2e76891c-b620-4cc0-9315-6f1217b09b1e	9	4	15	28	HRP	6	11	15	32	HRP
2e8ad1cd-d5d5-4bb4-8bbd-e9bef45088da	0	0	0	0	HRP	0	0	0	0	HRP
2ea2294d-fab9-43ae-a222-370487495b06	5	3	3	11	HRP	4	11	3	18	HRP
2ecd8358-c622-11e3-bf01-24c6515278c0	1	3	4	8	HRP	0	5	4	9	HRP
2f0a660c-ba3c-49bb-90f7-39b0034cea82	0	1	1	2	HRP	0	1	1	2	HRP
2f149d78-c623-11e3-bf01-24c6515278c0	7	2	8	17	HRP	4	7	8	19	HRP
2f2eaecc-6509-423f-b63a-8c3bea1ba4a4	9	9	15	33	HRP	3	17	15	35	HRP
2f324d8b-ec7b-4d3b-9d64-65f9fc6630a2	2	2	1	5	HRP	2	2	1	5	HRP
2f79fe89-9d24-4fbe-ba5b-0ff6c3c4d663	4	4	4	12	HRP	2	9	4	15	HRP
2fdab641-d73b-4f9a-aa4c-c1944f131a69	2	0	2	4	HRP	2	1	2	5	HRP
2fdfb06c-0d2f-4e1d-9756-bcb08a7f90af	11	8	11	30	HRP	6	11	11	28	HRP
2fe2433b-9a55-431f-a869-2b5a63e8e8fc	14	13	14	41	HRP	10	20	14	44	HRP
301d6ce3-4099-4c1d-8e50-c04b7ce91450	13	7	5	25	HRP	10	19	5	34	HRP
30376989-7edb-4863-9496-1789eccef8c4	0	4	6	10	HRP	0	6	6	12	HRP
303abbe5-4155-4a0d-bc3b-f8995261ca52	2	3	6	11	HRP	2	12	6	20	HRP
304c3e10-583c-421d-ab01-15c937d5014a	6	3	5	14	HRP	4	8	5	17	HRP
305a5074-5384-45a0-985d-289b178d09f6	3	0	3	6	HRP	2	2	3	7	HRP
30600994-c1ec-44c9-a620-3f6c617eb928	9	7	10	26	HRP	5	8	10	23	HRP
306ef5bc-97d0-4312-ae0e-343c4e31d869	3	4	2	9	HRP	3	7	2	12	HRP
309f5324-5608-4f62-b744-5ab268b70927	4	2	6	12	HRP	3	3	6	12	HRP
30a8f292-c623-11e3-bf01-24c6515278c0	10	2	11	23	HRP	7	5	11	23	HRP
30b9ab02-60f2-4974-85a9-874f247ae932	9	1	12	22	HRP	7	8	12	27	HRP
30dbe353-86d5-40ed-84c2-dbddf7beb17b	2	2	2	6	HRP	1	3	2	6	HRP
3166f1ae-678d-42ae-9d44-d3d25d6860c7	3	4	5	12	HRP	1	5	5	11	HRP
3189bc97-afd8-4daf-80c9-2d78a08228d3	2	0	1	3	HRP	2	1	1	4	HRP
31a70598-33be-4f09-9990-bd7594467802	2	3	2	7	HRP	1	4	2	7	HRP
31bc44b9-35ff-43fd-8a01-a834f3b1ce46	10	10	10	30	HRP	8	21	10	39	HRP
31bcfd64-c622-11e3-bf01-24c6515278c0	1	1	3	5	HRP	0	3	3	6	HRP
31c0c8f8-c623-11e3-bf01-24c6515278c0	4	1	5	10	HRP	4	2	5	11	HRP
31c75873-abb4-4d88-9e2f-07497a6c892d	22	9	30	61	HRD	18	33	30	81	HRD
31e63f89-a6a9-40fb-823d-f41587bd73d8	0	0	0	0	HRP	0	0	0	0	HRP
31f02f48-44a4-445e-ac3d-e9bf3d8d25a2	0	0	0	0	HRP	0	0	0	0	HRP
31f3ff14-7d74-447c-a5da-9ad8336c3f3f	16	7	15	38	HRP	16	20	15	51	HRP
322f0b01-2118-4dbe-aba1-3875a54ee71b	9	8	16	33	HRP	6	12	16	34	HRP
3232f77f-b745-4232-a802-6699b6356efd	1	2	2	5	HRP	1	3	2	6	HRP
324adcfa-3fba-45b9-99f0-9d41c0c54d79	0	0	0	0	HRP	0	0	0	0	HRP
3269608c-5dd7-452a-976a-31ac971aac2f	17	8	20	45	HRP	11	16	20	47	HRP
32a63b4f-3baa-4987-ad30-5bd0c0548088	1	3	5	9	HRP	1	3	5	9	HRP
32be40fa-c623-11e3-bf01-24c6515278c0	3	3	3	9	HRP	2	3	3	8	HRP
32d8c373-b5c8-420b-9808-8812b5501649	7	6	4	17	HRP	5	13	4	22	HRP
32fa6457-c8bd-4d26-8106-925baf13df68	7	3	20	30	HRP	6	13	20	39	HRP
33061bf5-9b99-4735-a810-f2d5eeef6873	8	2	8	18	HRP	7	3	8	18	HRP
33070975-0f35-4518-9ffb-4c6170c32534	6	2	6	14	HRP	6	5	6	17	HRP
335c721a-3653-471f-b0ec-6144fe868c6a	0	0	0	0	HRP	0	0	0	0	HRP
33992441-4f34-42f2-ba87-6ddd227f2250	21	6	14	41	HRP	17	21	14	52	HRP
339a2c94-55c9-4113-a706-b0971fa2784f	1	1	0	2	HRP	1	3	0	4	HRP
33a8693c-c623-11e3-bf01-24c6515278c0	6	2	8	16	HRP	3	4	8	15	HRP
33b7e799-ad10-498f-9948-8ce433311539	0	0	0	0	HRP	0	0	0	0	HRP
33b99e90-741d-43f2-804b-75721199a0dc	0	0	0	0	HRP	0	1	0	1	HRP
33bcd589-80db-4a58-8f83-a48cb60e0fda	10	4	10	24	HRP	8	9	10	27	HRP
33bf46dd-16b3-49c6-80d7-76caf27aa0f4	4	0	6	10	HRP	1	4	6	11	HRP
33de44a2-bec1-402d-872c-d78c1f2d52b3	2	1	3	6	HRP	0	9	3	12	HRP
33ea81f2-db2c-4567-bd7b-4cb9aadfef88	23	15	23	61	HRD	20	43	23	86	HRD
34030a28-c622-11e3-bf01-24c6515278c0	1	0	3	4	HRP	0	2	3	5	HRP
3433b1f3-59d1-4ac2-9bbf-e0c4042b4ddc	11	6	19	36	HRP	8	24	19	51	HRP
343fcbc2-f30c-4ffa-a0b3-f5bb21e5e70b	14	6	13	33	HRP	7	17	13	37	HRP
345a06d6-fa5c-4674-a847-88a6b537cf3c	0	0	0	0	HRP	0	0	0	0	HRP
34739bd6-b3be-441d-8cdb-e4233bf14080	1	1	2	4	HRP	0	2	2	4	HRP
34881c6b-f59f-42c0-9f29-9c5c47262ae6	37	15	18	70	HRD	29	29	18	76	HRD
34a445c2-1eb4-4a9f-8838-cddc2f82aae4	13	7	17	37	HRP	9	30	17	56	HRD
34ab4c57-5240-4af7-a329-a5ab55934fd4	1	2	2	5	HRP	0	4	2	6	HRP
34b0c838-bf6c-4d0f-8cd2-d2928adbb539	2	1	2	5	HRP	2	2	2	6	HRP
34c24482-c623-11e3-bf01-24c6515278c0	4	0	5	9	HRP	2	2	5	9	HRP
34d7b6cc-cfcf-4178-b075-f4d129ab18f7	6	5	16	27	HRP	4	9	16	29	HRP
351db483-a70e-496d-b70a-7449875121ee	4	3	7	14	HRP	3	8	7	18	HRP
352fbbb4-88a5-4354-b1fa-3a01da3fbfa7	0	0	0	0	HRP	0	0	0	0	HRP
35553150-e4ef-4539-b220-259f2d634bd7	5	5	4	14	HRP	5	9	4	18	HRP
3585e133-b3c1-4d90-b5f2-2b867e0ae0ec	8	5	20	33	HRP	5	22	20	47	HRP
35a74e53-16ff-4764-8397-6a9b02dfe733	11	4	11	26	HRP	9	14	11	34	HRP
35b951c0-edb0-47c4-9076-ede346ea7cb1	1	1	0	2	HRP	0	3	0	3	HRP
35c797fd-ca81-4cef-b6c4-7e3776f661b3	1	10	30	41	HRP	1	42	30	73	HRD
35cca3b8-c623-11e3-bf01-24c6515278c0	3	6	3	12	HRP	1	6	3	10	HRP
35ceba07-0759-4fbe-b076-af821a528cf0	10	10	13	33	HRP	8	17	13	38	HRP
35dc84c1-476c-4d48-ae23-622bf6e043ac	19	5	22	46	HRP	13	26	22	61	HRD
35e33a7a-c622-11e3-bf01-24c6515278c0	5	6	14	25	HRP	2	22	14	38	HRP
35eb6ecf-9514-4416-94b1-02200c0a1571	16	13	26	55	HRD	13	40	26	79	HRD
35f82a33-bde2-47e2-8aba-ff1fd5920219	3	4	5	12	HRP	1	6	5	12	HRP
36160be6-368f-4cdb-b1ee-9ed5b64462fa	0	0	0	0	HRP	0	0	0	0	HRP
363d3a59-dce3-408d-a736-5c29ba9f9b6d	0	0	0	0	HRP	0	0	0	0	HRP
36680797-36de-413d-b2a1-8804ac1705e9	1	3	5	9	HRP	1	4	5	10	HRP
367fdef3-d7af-4996-932f-cc5087e843dc	1	0	1	2	HRP	1	2	1	4	HRP
368e592d-260c-4f58-81c4-a9f1e6177a4b	2	0	1	3	HRP	2	1	1	4	HRP
36962459-e81f-4b8c-a08d-df60ef3283a3	2	4	1	7	HRP	2	6	1	9	HRP
369c06f2-8904-49cb-99d1-dd297ed0cd0c	19	9	22	50	HRP	14	21	22	57	HRD
36d1a85e-a09b-4537-86e0-eaf1eb03aed8	33	9	20	62	HRD	28	43	20	91	HRD
36d9c1aa-c623-11e3-bf01-24c6515278c0	5	7	15	27	HRP	4	13	15	32	HRP
36e1d9cc-32ec-4a0a-8fb1-c46f058a6fb8	3	4	7	14	HRP	1	5	7	13	HRP
371235d9-55b8-40a7-8cd6-baa7c2ad0493	6	5	9	20	HRP	4	20	9	33	HRP
3728982b-4547-4249-bd42-72a91d3fda8c	0	0	0	0	HRP	0	0	0	0	HRP
374cbd87-428e-4509-85c1-b7d3302c30a0	2	2	4	8	HRP	2	8	4	14	HRP
37522f18-77b2-4414-8df8-3c2c8048adba	17	8	22	47	HRP	14	26	22	62	HRD
37c913e6-9ce5-4338-8849-b5bf7862d36a	0	0	0	0	HRP	0	0	0	0	HRP
37d0cf1b-1743-4852-8073-372b16b5c17d	5	2	7	14	HRP	4	4	7	15	HRP
37e5d47b-851b-47de-ba6a-fd2835644011	3	3	3	9	HRP	3	4	3	10	HRP
380593d8-c623-11e3-bf01-24c6515278c0	9	7	16	32	HRP	4	14	16	34	HRP
384ef419-ee94-4563-9237-236fddeb4b64	11	2	15	28	HRP	10	12	15	37	HRP
3869ff3f-21b9-4817-8ff4-83c6fc75ab11	2	4	6	12	HRP	2	9	6	17	HRP
387c6519-6529-4074-a5ab-00f8052a5732	7	3	11	21	HRP	3	9	11	23	HRP
388a8875-c3f5-494e-8456-28be8d3626e1	0	0	0	0	HRP	0	2	0	2	HRP
38d8e626-c622-11e3-bf01-24c6515278c0	4	5	5	14	HRP	2	7	5	14	HRP
3914c02e-44ad-4c96-8464-61aa95b42c49	1	0	3	4	HRP	1	3	3	7	HRP
391a949d-217a-472c-a6d4-80e548039684	1	0	2	3	HRP	1	0	2	3	HRP
3933c60d-73d6-4f74-ae02-fd545fc1f092	8	5	20	33	HRP	4	21	20	45	HRP
3935af50-d992-4430-9909-e688347aead9	0	0	0	0	HRP	0	1	0	1	HRP
39458b0e-c623-11e3-bf01-24c6515278c0	3	1	5	9	HRP	2	1	5	8	HRP
39520be3-a2af-4189-acf4-9d239363333a	5	4	6	15	HRP	5	10	6	21	HRP
39a5d94d-e8c8-4057-be96-362ffbafb94d	0	0	0	0	HRP	0	0	0	0	HRP
39aee9fc-fa27-4b71-b9e8-43ff34bd3930	2	2	2	6	HRP	1	4	2	7	HRP
39c476fd-273b-4136-874c-53352f1be008	3	3	5	11	HRP	0	5	5	10	HRP
39c55051-e1bc-4081-962a-17205645de45	0	2	2	4	HRP	0	2	2	4	HRP
39c6c3b3-4683-4d11-984c-ed589188da65	9	3	3	15	HRP	6	8	3	17	HRP
39d38c06-3779-4ca4-b103-1d096f93dae8	5	0	8	13	HRP	3	8	8	19	HRP
39e32615-0160-4f13-b330-50748f5d87ed	4	5	0	9	HRP	2	8	0	10	HRP
3a18aa52-b6e2-4d03-ad05-ef99d653f0e0	0	0	0	0	HRP	0	0	0	0	HRP
3a49a936-c623-11e3-bf01-24c6515278c0	0	1	3	4	HRP	0	3	3	6	HRP
3a551616-4840-4111-a8c5-b4aa773d82c2	30	5	20	55	HRD	23	20	20	63	HRD
3a5eaed6-fcfd-437a-b61c-fd3725c64717	8	6	22	36	HRP	5	16	22	43	HRP
3a6bce45-0431-49d8-82df-b1d9a738e5a6	10	7	23	40	HRP	8	21	23	52	HRP
3a81f733-b3a3-4578-b925-a663612bc92c	3	4	4	11	HRP	1	9	4	14	HRP
3ace181a-23bd-424e-a87e-e0c01a2a2cb8	1	0	0	1	HRP	0	0	0	0	HRP
3ad44032-01fb-4f84-b880-f01bb13a4359	1	0	0	1	HRP	1	0	0	1	HRP
3ae3ce4a-54ec-4c3b-83f2-845696ea0fa1	2	0	3	5	HRP	2	0	3	5	HRP
3afae3fb-2d87-4724-a589-d31cce1f4c28	0	0	0	0	HRP	0	0	0	0	HRP
3afb3f57-545a-4ed5-9461-2fcb28d89399	1	2	4	7	HRP	0	5	4	9	HRP
3b02a7a7-e5bc-4e77-b691-521603630b00	7	4	7	18	HRP	6	8	7	21	HRP
3b20d548-2a7d-4031-85a1-425ca7201d7a	33	14	24	71	HRD	24	40	24	88	HRD
3b399659-8302-428a-9c97-1e7b455c9c2f	4	4	7	15	HRP	3	7	7	17	HRP
3b41cb48-c623-11e3-bf01-24c6515278c0	14	15	14	43	HRP	10	19	14	43	HRP
3b4ff158-c6d8-4a26-9568-0634ddb4a609	1	0	1	2	HRP	1	0	1	2	HRP
3b526846-72d6-4e10-b7cd-8cdb45a92a1c	17	18	20	55	HRD	12	30	20	62	HRD
3b55c58d-f95a-4a1d-9aa1-8d2c026656a9	2	3	3	8	HRP	2	6	3	11	HRP
3b590d75-ccfb-4da8-a2e9-10fb07e02cea	8	11	22	41	HRP	5	23	22	50	HRP
3b7810f7-f8ff-4d62-b766-3ba06170194c	1	3	3	7	HRP	0	4	3	7	HRP
3b8ab548-6669-4142-9612-cafded0d7a23	9	5	5	19	HRP	6	12	5	23	HRP
3bacc189-01b8-46cc-a442-f393c0f428c6	4	2	8	14	HRP	2	7	8	17	HRP
3baecfba-6977-4374-8bc9-22240abad9b5	0	0	0	0	HRP	0	0	0	0	HRP
3bb25b72-ceb1-4169-891e-339f22cb0f03	0	0	0	0	HRP	0	0	0	0	HRP
3bb4c27b-4d0d-4d13-b910-41a9ebf95880	14	10	17	41	HRP	8	22	17	47	HRP
3bfbc33d-804b-4bb3-97ac-97563d77b13d	6	6	10	22	HRP	5	12	10	27	HRP
3c019b2f-52ec-40a8-99b5-98c1423ce627	4	4	7	15	HRP	2	7	7	16	HRP
3c2b1509-1eb9-4b79-9569-57810f291499	18	11	14	43	HRP	12	14	14	40	HRP
3c30b10e-c623-11e3-bf01-24c6515278c0	1	0	2	3	HRP	0	4	2	6	HRP
3c78970e-c622-11e3-bf01-24c6515278c0	0	1	3	4	HRP	0	3	3	6	HRP
3c86ba21-7b11-4ec7-9d20-a2325197c676	7	6	18	31	HRP	4	10	18	32	HRP
3c92c0e9-68e0-4354-8ed1-b6506878145d	3	3	4	10	HRP	3	4	4	11	HRP
3c963890-6e79-4b16-a4aa-bac04938b4d7	14	7	19	40	HRP	9	37	19	65	HRD
3d400522-c623-11e3-bf01-24c6515278c0	2	3	8	13	HRP	2	5	8	15	HRP
3d477ac1-3bdf-4410-9594-1a3a1412c6ae	4	4	2	10	HRP	4	6	2	12	HRP
3da169e8-844a-4eee-b794-a2eb81db779a	11	2	11	24	HRP	7	10	11	28	HRP
3db3b7b1-da1d-4b9c-a92a-c60fecf4328c	17	16	25	58	HRD	15	40	25	80	HRD
3db6e6cc-1a06-49b9-834e-b6611cde4c4b	0	0	1	1	HRP	0	0	1	1	HRP
3de261ea-6478-4f96-8ca1-30be130e945f	0	0	0	0	HRP	0	2	0	2	HRP
3e012b50-06d1-4120-971b-5e54139b00ee	4	6	6	16	HRP	4	8	6	18	HRP
3e1180a5-149c-4e6c-9a29-696e3ba567e3	0	1	1	2	HRP	0	1	1	2	HRP
3e2a85d0-c622-11e3-bf01-24c6515278c0	5	1	7	13	HRP	3	5	7	15	HRP
3e4d0e50-8cf4-4eb0-a00a-ccf0484ecc2f	28	9	27	64	HRD	17	30	27	74	HRD
3e604a1c-b95f-44ff-9723-e2fac845da3b	10	6	9	25	HRP	5	11	9	25	HRP
3e68233a-c623-11e3-bf01-24c6515278c0	2	3	8	13	HRP	1	6	8	15	HRP
3e6a17f9-c249-41b6-ba49-55aaa39d21c5	18	9	16	43	HRP	14	24	16	54	HRD
3e7a30e6-2202-40bd-bfc1-0383604050da	0	0	0	0	HRP	0	0	0	0	HRP
3e7ccab5-5b1d-4147-b907-77cab8f0837e	2	5	2	9	HRP	1	8	2	11	HRP
3e86e68b-d083-4450-b056-4cd0f8d4a084	0	0	1	1	HRP	0	6	1	7	HRP
3e8a2c90-e747-4a22-bc9e-0b062479fec2	0	0	1	1	HRP	0	0	1	1	HRP
3e94aa64-7dd3-4d63-a5de-b4050d3dfafa	0	1	0	1	HRP	0	1	0	1	HRP
3ed783cf-2248-44a1-a2a2-d6b6519b91ef	15	14	25	54	HRD	9	33	25	67	HRD
3ee54a3c-69ba-479a-b1fe-79917e1b6dd5	1	2	0	3	HRP	0	5	0	5	HRP
3f039593-91d1-43cb-a06b-41e92f7e8d20	0	0	0	0	HRP	0	0	0	0	HRP
3f2ecbcd-5c9e-4d57-8aa5-962e2e86a83c	10	4	5	19	HRP	8	10	5	23	HRP
3f3aff50-d71b-44af-85d4-f81e813ea420	2	2	3	7	HRP	1	2	3	6	HRP
3f72f750-5666-44e7-acaf-a912d89475be	0	0	0	0	HRP	0	2	0	2	HRP
3f98d326-5676-4257-9af8-0a5f5d3c2527	25	15	22	62	HRD	18	24	22	64	HRD
3f99ae0e-c623-11e3-bf01-24c6515278c0	5	3	5	13	HRP	3	9	5	17	HRP
3faeb03e-c622-11e3-bf01-24c6515278c0	12	11	20	43	HRP	8	22	20	50	HRP
3fb8f017-576f-4901-b8bf-3a58e5d43de3	8	3	9	20	HRP	5	10	9	24	HRP
3fba4880-cb7b-4ac5-ab5f-728614faa1ea	5	2	15	22	HRP	5	4	15	24	HRP
3feac02a-c99f-4dd9-9eff-e4f5e87f7dc5	1	3	4	8	HRP	0	3	4	7	HRP
4019c219-c51e-479f-8a9d-cfa6816ed696	4	2	5	11	HRP	3	4	5	12	HRP
40378b7a-a65d-4510-aaba-a34c4058fac7	8	5	16	29	HRP	4	12	16	32	HRP
408ed640-75f6-4346-bdd0-3b93c51adae5	3	3	3	9	HRP	1	7	3	11	HRP
40b1e928-c623-11e3-bf01-24c6515278c0	4	6	8	18	HRP	2	9	8	19	HRP
41027c0b-85af-4c78-bba0-0da63cd75fa9	8	6	5	19	HRP	5	18	5	28	HRP
41840dc1-5ea2-4f01-a0d4-8b65add641c8	3	5	11	19	HRP	1	10	11	22	HRP
418a3dec-96ff-4719-becb-e1a8260cce2f	6	9	15	30	HRP	5	19	15	39	HRP
418e916b-7a4e-4fab-8616-15dcec4d79f8	61	11	22	94	HRD	56	24	22	102	HRD
41a7b031-d928-4a1f-891b-82fb3f6d548f	18	9	23	50	HRP	13	25	23	61	HRD
41c565a9-d44a-447f-85c0-98f23bfee1b3	1	3	0	4	HRP	1	6	0	7	HRP
41d50a3c-49fc-4d8a-9c25-bbbcd3a5da6f	11	6	5	22	HRP	8	12	5	25	HRP
41dba8d1-8aad-474c-a82b-20b28ab818bd	7	10	6	23	HRP	4	11	6	21	HRP
41de507a-c623-11e3-bf01-24c6515278c0	8	4	9	21	HRP	4	10	9	23	HRP
41f140b8-72b9-4ae3-8b25-6144d9f94d0f	4	3	6	13	HRP	4	16	6	26	HRP
42465bbd-289b-4e96-98fe-76809c5e1520	26	10	21	57	HRD	19	20	21	60	HRD
4255582e-c622-11e3-bf01-24c6515278c0	13	8	14	35	HRP	8	12	14	34	HRP
42629ae0-9410-4fac-8df1-2c276467deb5	20	3	20	43	HRP	16	20	20	56	HRD
4283773c-c04b-4f33-a398-f3566f6d293a	25	11	25	61	HRD	18	34	25	77	HRD
428c100f-d7d0-4860-a8fc-2bae6a4bba95	4	2	9	15	HRP	1	7	9	17	HRP
429aad6f-816d-4739-baa3-b0ebf2fcd501	11	14	17	42	HRP	8	28	17	53	HRD
42a548f0-d86a-4273-8bda-be0fe6a53b20	8	8	3	19	HRP	6	17	3	26	HRP
42af8f74-fd4b-486d-bc11-db53cc471d62	25	18	25	68	HRD	17	36	25	78	HRD
42d20028-0ddc-4dac-9f05-d674f8915f21	1	2	0	3	HRP	1	2	0	3	HRP
42de1441-6f3c-4b4d-b8b8-ad91e4b1dbe2	1	0	0	1	HRP	1	4	0	5	HRP
42e92d78-c623-11e3-bf01-24c6515278c0	5	4	8	17	HRP	4	6	8	18	HRP
42f00950-09c9-461a-8423-d5b04a96af10	7	5	14	26	HRP	6	9	14	29	HRP
42f88b95-fa12-47c7-93f1-cf72f207291c	1	0	0	1	HRP	0	0	0	0	HRP
43206cb7-787d-4f68-8019-55e8585c4b4d	0	2	3	5	HRP	0	2	3	5	HRP
436af904-65b2-4196-ad8c-a4e98081ee41	2	3	5	10	HRP	1	3	5	9	HRP
43aa4123-0fe2-4071-8a81-cbdd0410b917	10	4	14	28	HRP	6	15	14	35	HRP
43b675e0-22e0-42d6-a060-afc93e22ac95	8	5	1	14	HRP	8	8	1	17	HRP
43be43cb-a367-4a74-94e4-973acafcf576	9	3	11	23	HRP	4	8	11	23	HRP
43bf37e0-3dbc-4360-818c-fc1356d77495	0	0	0	0	HRP	0	0	0	0	HRP
43d630aa-3890-401c-bf56-e3a9f325734f	0	0	1	1	HRP	0	0	1	1	HRP
43dadc68-c623-11e3-bf01-24c6515278c0	6	4	7	17	HRP	5	15	7	27	HRP
43f7a2e0-fec9-4e43-872d-18c6c946fa17	47	14	28	89	HRD	39	68	28	135	HRD
44083f54-0953-48e3-a704-11ad0988ad2e	9	11	1	21	HRP	7	14	1	22	HRP
441d2f21-b448-4fc8-8c54-9b85aca56237	4	3	8	15	HRP	3	12	8	23	HRP
44406493-37f4-48c7-961b-8714be50773a	0	0	0	0	HRP	0	0	0	0	HRP
446437de-c622-11e3-bf01-24c6515278c0	9	4	9	22	HRP	6	11	9	26	HRP
448af8b4-e071-48b0-a65b-b4ad17afdc0c	8	3	10	21	HRP	5	12	10	27	HRP
448fe471-3f4e-4dc8-a4e0-6f147dc93abe	8	5	24	37	HRP	6	25	24	55	HRD
44e4f08a-c623-11e3-bf01-24c6515278c0	2	1	2	5	HRP	2	3	2	7	HRP
44eebc04-c027-45ae-beca-c4012b494f29	18	6	18	42	HRP	10	18	18	46	HRP
4508ce0a-5a2e-4502-98e9-2fd76c4eebef	1	1	1	3	HRP	1	1	1	3	HRP
450e8eba-a3a9-4dcb-b423-e33dfcd5c34e	10	4	18	32	HRP	7	13	18	38	HRP
45348eff-4b09-4776-825e-b18de9dba937	0	0	2	2	HRP	0	1	2	3	HRP
45614404-2149-4468-848c-0796e3757d62	3	2	3	8	HRP	1	3	3	7	HRP
45a7949d-e63f-4956-866c-df51257032de	16	7	16	39	HRP	13	18	16	47	HRP
45aedf22-c622-11e3-bf01-24c6515278c0	3	2	4	9	HRP	2	5	4	11	HRP
45d0ccb2-641f-4348-b3a8-61f4113cd85b	3	3	0	6	HRP	2	6	0	8	HRP
45e16b70-c3ec-493e-86d1-505ffdf5056c	41	15	31	87	HRD	32	48	31	111	HRD
460f7427-ebcf-404b-9e9e-e0278d0bca95	35	12	33	80	HRD	28	45	33	106	HRD
461df2ae-fcf1-4b93-be0a-c14954fe7c42	5	8	7	20	HRP	3	10	7	20	HRP
4624fd20-e2ad-4826-b606-a694b04e1076	3	2	6	11	HRP	2	3	6	11	HRP
463bf060-8ba6-4a73-8173-172025f7b527	1	0	4	5	HRP	0	1	4	5	HRP
4652ae03-b096-42d0-bdfa-3f6281d4f023	8	4	18	30	HRP	6	13	18	37	HRP
46693a2b-5105-4770-a9e1-031dfedeb694	9	7	12	28	HRP	6	14	12	32	HRP
4679f37a-4f09-449b-a1d8-1f02847996da	38	17	28	83	HRD	22	37	28	87	HRD
467ef778-f481-44f3-9768-b9900252d2ba	28	20	20	68	HRD	16	31	20	67	HRD
468083cb-95c3-47c1-9d96-79bcf7bf3f26	2	2	5	9	HRP	1	3	5	9	HRP
469eddf2-6e02-46bf-820f-6296a2b776e2	1	0	4	5	HRP	1	0	4	5	HRP
46d35b82-e1b7-4d35-be5e-3a70fd47e421	3	1	3	7	HRP	1	1	3	5	HRP
46e166fe-3b20-49ad-98db-42c854c61c93	6	4	1	11	HRP	4	5	1	10	HRP
46e503ae-461d-443a-869b-f261c5570de1	0	0	0	0	HRP	0	0	0	0	HRP
46f19b5c-3eba-4b23-a1ab-9748090ca4e5	20	21	16	57	HRD	14	38	16	68	HRD
47050918-c623-11e3-bf01-24c6515278c0	3	2	2	7	HRP	2	2	2	6	HRP
4729fe4b-c1ac-489b-a67e-91e5c5e3ff8c	1	1	2	4	HRP	1	1	2	4	HRP
47312f61-5ef4-4f25-9320-8fbb4758790e	30	14	20	64	HRD	28	34	20	82	HRD
473fe833-fcc6-485e-93d2-95e662c3ef53	0	0	0	0	HRP	0	0	0	0	HRP
475bca00-9089-4f50-8638-4e5e8aca6dcd	3	1	2	6	HRP	1	3	2	6	HRP
47874ff4-0b1c-4a31-9192-2a10e93ce9a1	21	16	24	61	HRD	19	33	24	76	HRD
47b5d831-5287-4f62-b17a-6e5eff2e4184	9	5	15	29	HRP	5	15	15	35	HRP
47d77750-c622-11e3-bf01-24c6515278c0	14	10	18	42	HRP	9	20	18	47	HRP
47e5ff56-9534-4fcf-a593-33027e877f93	6	4	8	18	HRP	5	8	8	21	HRP
4808f9e1-452d-45eb-9b87-2f87c67d3452	1	2	0	3	HRP	1	2	0	3	HRP
4838b5a9-968c-4178-bffb-3fafe1f6dc09	5	2	10	17	HRP	4	14	10	28	HRP
483bb781-0179-42e1-bf9c-487b240769b8	2	1	0	3	HRP	1	2	0	3	HRP
484a41c8-fcaf-488d-97dc-bfe6a4b88a95	3	0	12	15	HRP	3	15	12	30	HRP
4853fd17-7214-4f0c-984b-1be0346ca4ab	1	2	1	4	HRP	0	2	1	3	HRP
48624a82-c623-11e3-bf01-24c6515278c0	8	5	4	17	HRP	7	10	4	21	HRP
48a0da38-8147-40fe-b683-3f070413a792	25	9	19	53	HRP	24	18	19	61	HRD
48b15122-b1e9-4c30-8fc5-70a07686779a	3	1	2	6	HRP	0	1	2	3	HRP
48c33a30-557b-4ecf-8066-5b4b068b5e3a	0	0	0	0	HRP	0	0	0	0	HRP
48f68f73-3ac0-44ac-ba12-b8889fcb7f38	24	15	22	61	HRD	18	26	22	66	HRD
48fadd0f-6561-4294-bff4-d5e4f7dfe79f	1	2	1	4	HRP	0	4	1	5	HRP
4904d56f-0fe7-4482-8f6d-9e54d261f399	4	4	5	13	HRP	1	5	5	11	HRP
492694a7-bb41-4128-a909-c424e7fc0c9e	1	1	2	4	HRP	1	1	2	4	HRP
492b4e58-12e2-47b2-bd47-28f8607072fa	2	2	1	5	HRP	2	4	1	7	HRP
493e7008-551c-4c0e-b567-a0f31868629e	13	7	24	44	HRP	10	19	24	53	HRD
494701ce-05d4-440b-a65e-d925902b9d42	0	1	2	3	HRP	0	1	2	3	HRP
49795e42-c623-11e3-bf01-24c6515278c0	3	1	7	11	HRP	1	4	7	12	HRP
498ecf81-921d-4df9-a6a4-a625f484e823	0	0	0	0	HRP	0	0	0	0	HRP
49900a43-d42e-4052-a8cb-1563b82ad0a0	0	0	0	0	HRP	0	0	0	0	HRP
49ad3c8d-88cd-43cd-a273-1623fe2aec0b	0	0	1	1	HRP	0	0	1	1	HRP
49b26ab5-2ca9-49b1-ae83-573fa41af2cd	0	0	0	0	HRP	0	0	0	0	HRP
49ce0836-adec-4f62-ac01-dbdfbb96d9fc	2	2	1	5	HRP	1	2	1	4	HRP
49dec0c2-8e75-4f44-a253-82b2ea605890	8	3	7	18	HRP	6	4	7	17	HRP
49fa7e44-c86f-4b1f-8849-e5fe5b9de734	1	1	3	5	HRP	1	1	3	5	HRP
4a1ad661-f6ae-44e8-b50b-72ff658ff22b	2	2	1	5	HRP	2	4	1	7	HRP
4a35b01f-5e19-4673-abea-d87fd1d605d0	0	0	0	0	HRP	0	0	0	0	HRP
4a4309b0-2aca-4d6a-ac50-039b28406bba	2	2	5	9	HRP	2	5	5	12	HRP
4a4e0397-8702-46ef-aaa8-3980f03a40bf	0	0	0	0	HRP	0	0	0	0	HRP
4a698352-25e6-4137-bef8-b6520d5b1b95	1	0	4	5	HRP	1	0	4	5	HRP
4a703d3e-c623-11e3-bf01-24c6515278c0	1	2	4	7	HRP	0	3	4	7	HRP
4a88981e-e409-440f-9bf0-71ca1bab8b4e	3	4	8	15	HRP	1	6	8	15	HRP
4aa7eabc-0419-4897-b7af-5dcccfd6ac2f	40	19	25	84	HRD	30	56	25	111	HRD
4adc846a-42cb-4ebd-a954-e31eb29d7572	5	7	8	20	HRP	5	9	8	22	HRP
4b44b313-6f74-4233-bec4-7e41c91c77f1	2	1	2	5	HRP	2	6	2	10	HRP
4b5d9d8c-ff95-45f4-9287-2804e8a98ade	2	1	3	6	HRP	2	2	3	7	HRP
4b7a704b-e516-4275-be11-45cc935237e2	0	0	0	0	HRP	0	0	0	0	HRP
4b8943be-c623-11e3-bf01-24c6515278c0	11	7	22	40	HRP	6	20	22	48	HRP
4b8c6b0c-0d0c-4834-a2f3-691e0919b902	1	2	0	3	HRP	1	2	0	3	HRP
4b91ece6-c9b2-4889-b18c-c63eb58eb061	0	0	0	0	HRP	0	0	0	0	HRP
4bae2f08-da75-4991-acb8-5ba9912f9131	0	0	0	0	HRP	0	0	0	0	HRP
4c027164-12de-456f-b933-6bc91f70b46f	5	1	8	14	HRP	3	7	8	18	HRP
4c183106-c622-11e3-bf01-24c6515278c0	1	2	2	5	HRP	0	2	2	4	HRP
4c2ad4a0-5d57-4e27-9f35-058b2f205f50	22	17	19	58	HRD	15	33	19	67	HRD
4c3840df-9824-40db-879e-6d24adc8c155	11	3	15	29	HRP	7	11	15	33	HRP
4c3eda94-56f4-46d3-8c88-50d476e773f6	2	0	1	3	HRP	2	0	1	3	HRP
4c3f733d-5fd5-4f67-af5f-8c36c5b37be2	1	0	1	2	HRP	1	0	1	2	HRP
4c4aa1b1-fda3-4c5b-b588-68aa727500ad	4	5	9	18	HRP	1	8	9	18	HRP
4c5228b5-bf31-4abd-a47c-d088e16dba13	4	5	6	15	HRP	1	11	6	18	HRP
4c59fb2d-21b6-4b09-8174-6102de736e4d	11	13	25	49	HRP	8	29	25	62	HRD
4c755527-3b5d-4d36-822d-990aa1003d6a	1	4	0	5	HRP	1	10	0	11	HRP
4c8afa82-c623-11e3-bf01-24c6515278c0	5	5	2	12	HRP	2	12	2	16	HRP
4cbe411b-b05e-46bd-bea8-126289a0866c	8	5	5	18	HRP	5	10	5	20	HRP
4ceeb025-2f16-4f80-b9b4-0151346349c6	1	4	2	7	HRP	0	4	2	6	HRP
4cfb0aee-6661-478a-8694-9d8ba15e46b7	4	1	8	13	HRP	3	2	8	13	HRP
4cff8590-559e-4204-8635-96e11bfeda68	2	2	5	9	HRP	1	9	5	15	HRP
4d11d7da-1204-437e-87b1-e8337a67c9a8	1	0	0	1	HRP	1	2	0	3	HRP
4d121008-0987-4142-a2b8-7dac58f3110a	3	1	6	10	HRP	1	4	6	11	HRP
4d1a4587-adb4-4a65-943e-f19efe8de142	0	1	0	1	HRP	0	2	0	2	HRP
4d2204f1-be84-4f58-b7e7-61ae9fbf6d25	5	1	1	7	HRP	4	2	1	7	HRP
4d409156-3a36-4c63-9ad6-b6af34f27b06	3	6	23	32	HRP	3	20	23	46	HRP
4d4eff82-ede0-47f1-b49a-ada025952114	9	3	13	25	HRP	3	10	13	26	HRP
4d690424-b015-46ae-885d-aa6d9031f66f	0	1	1	2	HRP	0	1	1	2	HRP
4d6bb438-86f0-4414-962f-2b1cebee4524	2	0	2	4	HRP	1	0	2	3	HRP
4d72d06d-b6af-4294-9eef-6e61e067761f	2	2	3	7	HRP	1	4	3	8	HRP
4d7f2c74-862b-4aad-98e1-fa831f14a905	9	5	7	21	HRP	8	10	7	25	HRP
4daa2708-d0db-40fe-a07a-763f003adcae	1	3	2	6	HRP	1	3	2	6	HRP
4dac9498-c623-11e3-bf01-24c6515278c0	5	1	5	11	HRP	3	4	5	12	HRP
4db9e471-0068-4ec6-9bcb-33ef5fdec33e	6	4	7	17	HRP	5	7	7	19	HRP
4dc9b032-7f7b-486d-a12b-8461af89501d	1	17	14	32	HRP	1	32	14	47	HRP
4de7441f-a609-4a75-9fe7-17a647079ac1	0	1	2	3	HRP	0	1	2	3	HRP
4e361622-f9a8-4e9b-a89e-19bafebe1d6a	0	2	1	3	HRP	0	2	1	3	HRP
4e596add-a7c5-4617-9649-b4ac6612e39c	0	0	0	0	HRP	0	0	0	0	HRP
4e7cdeda-6dc1-4f17-b853-72a68e5aa7e1	4	5	10	19	HRP	2	17	10	29	HRP
4e7e6e1f-c648-446f-bdf6-0b1fcc6dfa83	1	0	1	2	HRP	1	1	1	3	HRP
4e8396f7-9506-4401-96b6-bb2e89557d59	5	3	14	22	HRP	4	20	14	38	HRP
4e84eed6-82a8-4e91-b0fd-61ec6ef69ce9	8	6	19	33	HRP	6	21	19	46	HRP
4e913899-eeb8-4630-ba9d-41a81ced8069	22	6	24	52	HRP	13	24	24	61	HRD
4eac784b-084a-4106-9a76-2d9fbec57033	3	1	2	6	HRP	1	3	2	6	HRP
4ecbfd89-393f-4126-aa1c-951a2c23ef89	0	0	0	0	HRP	0	0	0	0	HRP
4ed52e0c-c623-11e3-bf01-24c6515278c0	9	17	12	38	HRP	5	33	12	50	HRP
4ef20a13-f107-4654-adca-fc60b8f5be47	7	5	6	18	HRP	4	8	6	18	HRP
4f1fc78e-733d-4c6e-86b2-dbe1f98c141d	9	13	20	42	HRP	5	22	20	47	HRP
4f3c2c94-fa7f-4945-9dff-e4d4dac95f56	2	5	6	13	HRP	0	8	6	14	HRP
4f6f48bc-c622-11e3-bf01-24c6515278c0	3	2	14	19	HRP	2	8	14	24	HRP
4fdc8980-c623-11e3-bf01-24c6515278c0	5	2	10	17	HRP	4	7	10	21	HRP
50203cff-83f8-4884-8346-b91ef717d00e	0	0	1	1	HRP	0	0	1	1	HRP
5042b417-d14e-42bb-b6f3-de303346a252	2	3	6	11	HRP	1	4	6	11	HRP
5046f1b4-9d95-4841-ba30-691fa44719a2	11	7	14	32	HRP	8	11	14	33	HRP
504cdfc5-6721-43ef-b31e-fdf52f0cd9cd	14	11	19	44	HRP	9	22	19	50	HRP
504d4cb0-d2dd-420d-82e6-9ec14434a0fc	25	11	23	59	HRD	17	26	23	66	HRD
50515723-b495-42a9-8750-e3da288bf6a3	0	3	2	5	HRP	0	4	2	6	HRP
507620ef-f0fc-4ac3-a7c0-ea2e36c40f77	5	10	14	29	HRP	3	22	14	39	HRP
50a5970d-a0cb-4251-8ab0-74ad0e94be9a	0	0	2	2	HRP	0	1	2	3	HRP
50b61288-1412-4104-92e6-8b1a359ef399	8	11	19	38	HRP	7	23	19	49	HRP
50e3a421-9741-4cd8-911b-0f47ca518b6a	17	6	14	37	HRP	12	15	14	41	HRP
50eb58ba-c623-11e3-bf01-24c6515278c0	2	3	5	10	HRP	2	5	5	12	HRP
50ee360c-e3df-4888-9999-ebb88e271d08	5	5	11	21	HRP	3	11	11	25	HRP
50f4d836-79a9-4bc7-a63a-7aa29e41d418	2	0	1	3	HRP	2	3	1	6	HRP
51206157-94cc-4702-8247-c98283b487aa	0	1	0	1	HRP	0	2	0	2	HRP
513bafce-375c-49b0-ae75-6c607abd05d8	1	1	2	4	HRP	0	2	2	4	HRP
51458c86-0fdd-470e-b059-1ffbffc92a7f	10	4	14	28	HRP	8	10	14	32	HRP
5174f450-0bf7-4237-a53e-844064f0e701	2	3	3	8	HRP	0	5	3	8	HRP
51800588-c622-11e3-bf01-24c6515278c0	6	7	5	18	HRP	4	10	5	19	HRP
5187e77d-f412-4303-8049-11d1aa1a0235	12	16	17	45	HRP	12	29	17	58	HRD
51893d3f-e7f3-43f9-9fd0-c0f25ae96804	7	1	12	20	HRP	5	5	12	22	HRP
518d6c1b-8234-40be-9560-6d383d5866fa	1	1	3	5	HRP	1	1	3	5	HRP
5193a482-6ed9-4504-bd7c-c8b9e4103577	12	10	13	35	HRP	10	19	13	42	HRP
51adf6cf-f422-4d7e-aa46-cc9bf0ef8693	6	12	13	31	HRP	5	26	13	44	HRP
51b25b37-f75c-4380-a0f6-5273e0b7ee33	24	21	24	69	HRD	13	31	24	68	HRD
51dd1a39-7349-442c-b7e1-7850fb800569	1	0	1	2	HRP	1	0	1	2	HRP
51e5a835-eb48-4640-87d0-f40f5e2bff18	0	1	2	3	HRP	0	1	2	3	HRP
520b8ab2-c623-11e3-bf01-24c6515278c0	2	3	7	12	HRP	2	7	7	16	HRP
522dc834-8367-4f49-b93b-fcba91a2de7e	9	10	13	32	HRP	6	21	13	40	HRP
524bbd14-1e1f-479b-9a71-d27fce32d8bc	9	12	21	42	HRP	7	27	21	55	HRD
5255d645-d3d2-422e-8449-046cd21f4935	18	8	11	37	HRP	13	17	11	41	HRP
526b3796-2cbd-4eec-8273-064b41456279	0	0	3	3	HRP	0	1	3	4	HRP
52910a60-bb15-4ba5-9d09-50d8ee6a445b	16	8	24	48	HRP	13	31	24	68	HRD
52d8ccfc-c623-11e3-bf01-24c6515278c0	4	6	13	23	HRP	2	13	13	28	HRP
52f2d49e-f24d-41d2-9f73-33bd1cc51bba	0	0	0	0	HRP	0	0	0	0	HRP
52f43b72-15ea-40a0-a3b4-4bf22bc0bf25	7	5	10	22	HRP	5	8	10	23	HRP
5310f698-d31a-4628-84b4-dc9ac29722a5	2	4	5	11	HRP	2	8	5	15	HRP
532259b8-c622-11e3-bf01-24c6515278c0	19	11	21	51	HRP	13	22	21	56	HRD
532bec86-b8d3-41a1-ba17-913a7d378f66	13	10	17	40	HRP	8	19	17	44	HRP
534d941c-ec2d-47eb-b2dc-d3f856d0b151	1	1	0	2	HRP	1	1	0	2	HRP
53534b3c-cd15-4d68-a9b1-6902bb234c45	16	11	14	41	HRP	12	19	14	45	HRP
536dedba-46c4-4a21-b112-13c030b13069	1	1	2	4	HRP	1	1	2	4	HRP
537cccf2-fb25-448b-813e-ca5d5642b910	0	0	0	0	HRP	0	0	0	0	HRP
53ac794d-1067-43e0-8dc0-43b131f43ec5	0	0	0	0	HRP	0	0	0	0	HRP
53bb7112-3e38-45fe-a9c4-1b0871babf4a	4	9	21	34	HRP	4	23	21	48	HRP
53bcbb68-addd-47fc-9910-cd1d3f38197d	20	11	20	51	HRP	13	20	20	53	HRD
53d32d8b-5649-42b0-8c52-2c39af2a961b	6	4	15	25	HRP	5	9	15	29	HRP
53dec97d-0464-4ffd-8e2e-95b2b9a03af0	6	4	2	12	HRP	6	6	2	14	HRP
53df19a8-c623-11e3-bf01-24c6515278c0	4	11	12	27	HRP	3	15	12	30	HRP
53e6a756-bdcc-4217-afe7-27d776159544	5	6	4	15	HRP	3	8	4	15	HRP
54195db3-94a9-4538-8bb8-9953d936acd4	24	21	19	64	HRD	18	43	19	80	HRD
541f91bd-7e9d-4348-9e78-45b948d8967e	10	4	7	21	HRP	5	6	7	18	HRP
54319e3d-c28f-4ba1-9c87-299d303e4de3	5	5	2	12	HRP	3	6	2	11	HRP
54354d24-c622-11e3-bf01-24c6515278c0	5	2	7	14	HRP	4	6	7	17	HRP
54426b1a-e0d3-4d8e-9e81-2d8e6b153b22	0	0	0	0	HRP	0	1	0	1	HRP
546b97b0-ab82-42a1-bbd2-241523278ec3	0	0	0	0	HRP	0	0	0	0	HRP
546b982f-60d9-43df-9761-09369afbee2d	2	2	7	11	HRP	0	5	7	12	HRP
54842328-9432-4820-8976-7964bf9bf147	1	2	3	6	HRP	0	2	3	5	HRP
54a77010-2f16-4da9-8ca0-746a51801a00	21	12	17	50	HRP	18	24	17	59	HRD
54cfd4b0-c623-11e3-bf01-24c6515278c0	4	8	12	24	HRP	2	15	12	29	HRP
54e78de0-d357-4125-a904-ab35e461572b	30	6	20	56	HRD	24	23	20	67	HRD
551d5082-ab6a-4674-af0d-ce408f589949	4	7	0	11	HRP	3	10	0	13	HRP
5533240d-8fed-440d-b781-6092785a77ce	11	10	17	38	HRP	5	15	17	37	HRP
55345803-83d4-4fdb-b0ee-328753801da1	7	2	7	16	HRP	4	6	7	17	HRP
554b9439-7e11-43ec-8bc3-448c59100b9e	13	5	21	39	HRP	10	13	21	44	HRP
558239c7-a160-4228-8fdf-a0a1d2f62133	6	8	17	31	HRP	3	12	17	32	HRP
559c30f2-8ae7-43c8-819c-800261065e06	2	0	1	3	HRP	0	2	1	3	HRP
55ada396-0878-4724-8ebe-00da367eed3d	33	9	15	57	HRD	25	13	15	53	HRD
55c75a2a-f3d2-4469-9d23-604cf539d548	1	0	2	3	HRP	1	0	2	3	HRP
55c82198-5be6-4cc5-b5b3-b707af234107	0	0	0	0	HRP	0	0	0	0	HRP
55e520f4-0e4b-41a2-9951-c4e9f323100b	0	0	0	0	HRP	0	0	0	0	HRP
55e5497a-c623-11e3-bf01-24c6515278c0	2	3	5	10	HRP	1	7	5	13	HRP
561fd34c-7c7d-4df0-bbfc-3d31147ca562	3	2	6	11	HRP	2	4	6	12	HRP
56425c2e-6bbf-4b20-ba07-79a526dd4603	0	0	0	0	HRP	0	0	0	0	HRP
5650dc4e-8bce-4716-9199-cd5750d7a888	10	2	12	24	HRP	8	8	12	28	HRP
565e656c-d5e3-4fe4-a10c-2e9ca1e498b5	0	0	0	0	HRP	0	0	0	0	HRP
56681386-d407-4f53-ae4f-6c04437652f7	4	4	5	13	HRP	4	6	5	15	HRP
569393c8-e2fe-4580-a45b-81f1b1e01135	22	10	23	55	HRD	16	30	23	69	HRD
569ff1b4-de87-4309-8484-80549aaf9485	3	1	10	14	HRP	2	5	10	17	HRP
56c846d6-c622-11e3-bf01-24c6515278c0	2	4	3	9	HRP	2	4	3	9	HRP
56cc8740-b132-4cbc-b513-f0b5b2305ca6	14	7	22	43	HRP	10	20	22	52	HRP
56d4ea48-c623-11e3-bf01-24c6515278c0	2	3	5	10	HRP	1	5	5	11	HRP
56ddcb96-e90b-4fce-aa4c-c677bbfee488	7	9	8	24	HRP	5	14	8	27	HRP
56e57223-264e-489d-bc9a-a07789065c40	1	0	1	2	HRP	1	3	1	5	HRP
56ffaa35-814c-4c0b-b3c6-d4514d34fec2	4	7	14	25	HRP	4	23	14	41	HRP
5702affd-eafe-42a4-8f56-c1f22f8f184d	1	0	0	1	HRP	0	0	0	0	HRP
5714b52d-7048-41b5-8141-bf42d960abe4	0	0	0	0	HRP	0	0	0	0	HRP
571ce258-b453-4cac-b05e-05755791be84	1	4	4	9	HRP	1	5	4	10	HRP
573ee34b-43a7-40d8-95ee-0ced4b46a7c8	1	0	1	2	HRP	1	0	1	2	HRP
5769ae11-5f1b-483f-b228-7584591c66e6	7	5	7	19	HRP	6	12	7	25	HRP
576a1741-8c65-40da-9f0f-b2ca805d70f3	5	6	4	15	HRP	4	8	4	16	HRP
577d5c9e-fbda-41d5-b0b3-cdb733453ea5	1	3	2	6	HRP	1	4	2	7	HRP
578ba169-1d2f-4187-b174-082bbc6a5bd2	2	1	2	5	HRP	2	1	2	5	HRP
57947014-053e-4c34-b6a7-9e6f36f48010	0	0	0	0	HRP	0	0	0	0	HRP
5808f774-c623-11e3-bf01-24c6515278c0	7	6	14	27	HRP	4	12	14	30	HRP
581be6cf-9778-49c3-9c77-1316eaa78929	0	0	0	0	HRP	0	0	0	0	HRP
589daa3f-0b76-4c9c-b494-048955e36052	0	0	1	1	HRP	0	0	1	1	HRP
589e0aea-9057-4b8c-8af1-74c74fe46a38	2	0	1	3	HRP	1	0	1	2	HRP
58c7e9c3-1345-48c0-a758-0887358b8696	1	0	0	1	HRP	0	0	0	0	HRP
58d3e932-b4a3-4cac-a6ac-73160e354a15	13	5	20	38	HRP	7	16	20	43	HRP
58e2453c-bb58-43a3-9642-705ec0e0bdbd	1	1	0	2	HRP	1	2	0	3	HRP
58f4ff52-c623-11e3-bf01-24c6515278c0	2	2	4	8	HRP	1	6	4	11	HRP
58faf969-bf37-4180-8807-2f44f2cc8eda	21	14	18	53	HRP	14	21	18	53	HRD
5912d4b3-2d5d-4b98-b967-1b4ff177097a	7	4	8	19	HRP	4	8	8	20	HRP
5935dd9d-d411-48f8-8512-aa73a63878b0	0	0	2	2	HRP	0	0	2	2	HRP
59632e7e-c622-11e3-bf01-24c6515278c0	13	5	14	32	HRP	6	8	14	28	HRP
5975deb5-00d2-4d18-b5c0-34ac9947fe11	4	2	8	14	HRP	4	4	8	16	HRP
597e4011-ea99-4356-b1d9-8cfe35db7c3b	1	2	4	7	HRP	1	4	4	9	HRP
59938f45-3e57-43d6-af3b-bb4968249e5a	5	4	3	12	HRP	3	6	3	12	HRP
59bfcb53-91c1-4dce-856a-f4afc8fa6224	1	0	1	2	HRP	0	0	1	1	HRP
59c18694-8a43-41dd-a6f6-52a20bc8dd54	2	1	2	5	HRP	1	3	2	6	HRP
59e2d6d1-debd-4796-ab0c-6a5673a990fc	0	0	0	0	HRP	0	0	0	0	HRP
5a51a6fc-c623-11e3-bf01-24c6515278c0	0	0	5	5	HRP	0	0	5	5	HRP
5a535c49-d42e-43c6-9d32-dc76f28d4f0f	0	0	0	0	HRP	0	0	0	0	HRP
5a5a8409-a8f2-4c7b-85e5-b8bd85f2930c	1	5	10	16	HRP	1	8	10	19	HRP
5a7f3c88-ef02-4e97-8009-5622245b6a09	3	2	7	12	HRP	2	5	7	14	HRP
5ab6a1d3-76f8-45d4-a430-d9831daa9ec4	5	3	10	18	HRP	2	6	10	18	HRP
5b178f44-c622-11e3-bf01-24c6515278c0	8	7	7	22	HRP	5	8	7	20	HRP
5b180356-cf58-4fad-a3d4-00fc12b43fcc	11	6	8	25	HRP	4	11	8	23	HRP
5b41e033-6df8-411e-a13b-59eeb8afbf9b	8	6	7	21	HRP	6	9	7	22	HRP
5b4b2312-acb5-4329-8d46-7f93213e3daf	0	0	0	0	HRP	0	0	0	0	HRP
5b560f4c-d2a3-43fa-b394-abef78bdefc1	11	9	12	32	HRP	5	18	12	35	HRP
5b7d5767-2037-4175-aec9-886776343181	7	5	14	26	HRP	3	18	14	35	HRP
5bb37ffc-c623-11e3-bf01-24c6515278c0	2	3	5	10	HRP	1	5	5	11	HRP
5bcf473f-417d-47a5-9745-ac7faf830b1f	4	7	8	19	HRP	4	14	8	26	HRP
5bdca282-c671-48ff-b32b-2380996016c0	0	0	0	0	HRP	0	0	0	0	HRP
5beafbbb-4613-4bab-977a-11c865e13a84	1	2	3	6	HRP	1	4	3	8	HRP
5bebc389-de0d-45b8-9d2f-6476988c358a	1	0	0	1	HRP	0	0	0	0	HRP
5c02d399-07af-4573-a568-bc1b256bc8f8	0	0	0	0	HRP	0	0	0	0	HRP
5c156f63-6537-4d93-a6c2-4155618cf638	1	0	2	3	HRP	0	1	2	3	HRP
5c3def3a-b515-41f6-8157-681b963534e7	3	6	14	23	HRP	2	14	14	30	HRP
5c4b369c-51a3-4ca7-8b9d-2a8e49c0dde7	2	3	5	10	HRP	1	3	5	9	HRP
5c775f90-83d4-4c1e-88c2-4e1ed1daa96f	1	1	3	5	HRP	1	1	3	5	HRP
5c8da06c-7964-4ad1-ac9e-d1b5507105d2	3	5	0	8	HRP	3	8	0	11	HRP
5c9b8a2c-c623-11e3-bf01-24c6515278c0	7	6	10	23	HRP	2	10	10	22	HRP
5cbd429f-ffab-41ad-8016-422f1c922e99	1	6	3	10	HRP	1	11	3	15	HRP
5cc7c966-499e-49e3-b509-4eeb00ee03d4	32	19	27	78	HRD	24	45	27	96	HRD
5cf21488-c622-11e3-bf01-24c6515278c0	2	2	6	10	HRP	1	2	6	9	HRP
5d58b984-e0b8-4237-a576-0e9d4079599e	2	2	2	6	HRP	1	2	2	5	HRP
5d6ad982-bb01-4233-b8fa-d129460eec79	5	6	4	15	HRP	2	12	4	18	HRP
5d922e48-aa70-454d-9417-c9af686feebc	11	6	16	33	HRP	6	13	16	35	HRP
5d9ff58c-5702-48fc-a66a-d1276327fd49	16	8	20	44	HRP	9	15	20	44	HRP
5dbf3203-ce73-41e4-bf9a-32fc856f73f5	35	17	32	84	HRD	33	70	32	135	HRD
5dc6f055-c4f6-49a1-a68c-94cf87cbd363	1	3	4	8	HRP	1	3	4	8	HRP
5dce221a-c623-11e3-bf01-24c6515278c0	13	14	21	48	HRP	12	20	21	53	HRD
5deeaa45-4c1b-4ab2-a487-93c548838f68	0	0	0	0	HRP	0	0	0	0	HRP
5df0aab4-0be2-4da3-a4b7-a10fca09a4ba	1	1	0	2	HRP	1	1	0	2	HRP
5df489bc-6178-49e4-8a42-506f70300dff	15	7	13	35	HRP	8	14	13	35	HRP
5e9c69d2-c622-11e3-bf01-24c6515278c0	5	1	4	10	HRP	2	1	4	7	HRP
5ead73fe-1c34-48ed-b20d-89fc3c82dbd6	17	3	11	31	HRP	12	11	11	34	HRP
5ecc88f7-8391-4168-af11-07a6bf9b3652	0	0	0	0	HRP	0	0	0	0	HRP
5eddfb26-c623-11e3-bf01-24c6515278c0	19	6	10	35	HRP	13	14	10	37	HRP
5ee1dda9-2e84-4617-af09-2ae02873b44d	4	3	2	9	HRP	0	3	2	5	HRP
5ee28a35-7aa0-48e3-9c14-daca7b0241fe	0	0	0	0	HRP	0	0	0	0	HRP
5f00a760-fbc0-41f0-b92b-b3c553eac0e5	3	6	9	18	HRP	3	11	9	23	HRP
5f096d7b-a1ea-4cc2-af73-10108089ae84	2	4	3	9	HRP	2	5	3	10	HRP
5f13e9b8-6c8e-4fd7-aef1-da4e5d5e2a5e	3	3	3	9	HRP	2	6	3	11	HRP
5f18b334-6616-406f-8f33-0592b56c14e6	0	1	3	4	HRP	0	2	3	5	HRP
5f53bcda-2fd3-4574-9cc2-5efe353372b2	0	0	0	0	HRP	0	0	0	0	HRP
5f94cb62-4019-47ff-bf6a-eeda8e9e033c	15	6	11	32	HRP	11	9	11	31	HRP
5fa88c3a-dbc1-43f2-82b2-e0592f35ce57	2	3	2	7	HRP	2	6	2	10	HRP
5fd632ea-085e-4e9b-8dcc-ec94e492d3bf	19	5	16	40	HRP	9	13	16	38	HRP
5fd77ba9-5015-4d8b-86a0-582e5c76bdd6	7	6	11	24	HRP	7	10	11	28	HRP
5fe83740-0688-46fe-97b4-4c7c8cfa206e	0	0	0	0	HRP	0	0	0	0	HRP
5fe8a231-bbac-4f91-a47a-0de4fee752d3	0	0	0	0	HRP	0	0	0	0	HRP
6012cb02-c623-11e3-bf01-24c6515278c0	9	3	8	20	HRP	5	7	8	20	HRP
603594e3-e427-494c-b9ee-e872d6629563	3	5	4	12	HRP	2	6	4	12	HRP
60413de1-6cd2-4f74-8180-3bdd394d6d16	8	3	10	21	HRP	7	21	10	38	HRP
6051f40a-99e5-4461-9255-0e70d757b4d5	11	3	12	26	HRP	5	13	12	30	HRP
60525b38-c34b-479b-86d3-013c7e567b8f	22	8	25	55	HRD	17	21	25	63	HRD
606111e3-6b7d-42a6-b7d0-9d6c3e33acd6	0	0	0	0	HRP	0	0	0	0	HRP
606d7f5e-ff98-4245-a9ac-281f5074f97a	1	1	1	3	HRP	0	1	1	2	HRP
60aff7a0-4960-4ed1-922b-3233ccbfdba1	11	4	15	30	HRP	9	10	15	34	HRP
60c33e32-7e19-4e71-b075-a63fcf27e660	7	6	10	23	HRP	5	11	10	26	HRP
60e78c80-41a5-456a-9a81-9007d18fd72c	15	1	17	33	HRP	12	8	17	37	HRP
60f81dba-c623-11e3-bf01-24c6515278c0	6	2	7	15	HRP	5	9	7	21	HRP
616ff577-c5c3-432e-a857-f29901de119c	1	0	2	3	HRP	1	0	2	3	HRP
6172ca02-c622-11e3-bf01-24c6515278c0	7	6	14	27	HRP	3	10	14	27	HRP
61973578-4c0d-4a3f-b9c4-f96ceab24629	2	4	0	6	HRP	2	7	0	9	HRP
61a48c69-4f7d-4dc6-aff7-88a6c33137df	1	2	0	3	HRP	1	2	0	3	HRP
61cad26a-cbc6-4977-83b9-dc61e49f2861	19	4	10	33	HRP	12	6	10	28	HRP
61d941f1-87df-43af-8a29-b6809c809275	3	4	7	14	HRP	3	8	7	18	HRP
6218f366-d5d2-4289-a95e-eeedfae7523a	2	0	4	6	HRP	2	8	4	14	HRP
622eaa04-b8f9-471b-98b0-7befd119f14c	38	13	24	75	HRD	30	24	24	78	HRD
6239e340-d50c-45b1-a7ca-e1135671ae0f	0	0	0	0	HRP	0	0	0	0	HRP
626c9788-d70c-449b-b9dc-5e3f6fc00991	3	2	4	9	HRP	2	3	4	9	HRP
627823ec-c623-11e3-bf01-24c6515278c0	10	4	10	24	HRP	10	9	10	29	HRP
6297aa77-37a0-4f46-987b-32bd8653c0c2	4	2	6	12	HRP	3	6	6	15	HRP
62ac7c91-da99-4144-b927-e90528dcd8d4	1	1	0	2	HRP	1	1	0	2	HRP
62ea1264-47b6-4a6b-9fa6-779837f8e905	0	0	0	0	HRP	0	0	0	0	HRP
62fceb56-8c6e-4d20-9d2f-5b7042854d23	0	0	0	0	HRP	0	0	0	0	HRP
631ab9d0-5400-400c-b0bc-c3e576bcfe06	11	9	12	32	HRP	6	14	12	32	HRP
631eedb3-dbd1-4606-90e1-ea91b9a77a5a	0	0	0	0	HRP	0	0	0	0	HRP
632f3eb0-c623-11e3-bf01-24c6515278c0	1	1	3	5	HRP	1	6	3	10	HRP
637208b2-d8b6-45a3-a389-6f34db18fea4	1	3	3	7	HRP	0	3	3	6	HRP
63762458-902a-4329-a823-703b54cb5f9d	4	5	5	14	HRP	4	6	5	15	HRP
638e80c7-9a6e-4a32-a621-fc4168e72343	0	2	2	4	HRP	0	2	2	4	HRP
63a907ff-1042-4f9c-a385-55a32b3e103b	0	0	1	1	HRP	0	1	1	2	HRP
63adc09c-e1b1-40dd-9c35-2f8276b656fc	4	5	10	19	HRP	3	9	10	22	HRP
63bc376e-5a3d-44fd-8d77-686dfc41e458	1	0	1	2	HRP	1	0	1	2	HRP
63d0c49d-918d-41fb-808a-1f8001981917	0	0	0	0	HRP	0	0	0	0	HRP
63db50d6-5ef2-44d0-9906-26eae74ecf44	9	3	14	26	HRP	5	17	14	36	HRP
63ea274b-d42b-4787-9c54-8ee95ea376ec	0	0	0	0	HRP	0	0	0	0	HRP
63f5bb12-1b20-49d4-9e98-570e368f947d	0	0	1	1	HRP	0	1	1	2	HRP
63faa59e-6649-412e-823a-338d0662ec72	1	1	1	3	HRP	1	1	1	3	HRP
63fef3fe-c622-11e3-bf01-24c6515278c0	5	4	9	18	HRP	3	5	9	17	HRP
6400c324-2c94-477d-acb9-669d4ea46f1e	0	0	0	0	HRP	0	0	0	0	HRP
642e1379-1061-40bc-9a4c-f7c191e84d9d	13	5	18	36	HRP	7	15	18	40	HRP
64446aec-c125-4c81-b9cc-62482cb1aaed	1	3	1	5	HRP	0	4	1	5	HRP
644c669b-937b-4adc-81b9-6a1811cba9da	5	4	4	13	HRP	5	4	4	13	HRP
64623aaa-a274-4baa-8b71-958d9c8df733	28	16	27	71	HRD	26	52	27	105	HRD
6495e68e-1434-45d3-a03d-f286447dda79	17	7	15	39	HRP	13	17	15	45	HRP
649f2c20-5b50-40a8-a6fd-9a51f3d5b9df	25	10	25	60	HRD	18	25	25	68	HRD
64a17d5b-8f40-4ccf-8f2f-e68c5fe6b1ff	0	0	0	0	HRP	0	0	0	0	HRP
64b80154-c623-11e3-bf01-24c6515278c0	2	3	2	7	HRP	2	5	2	9	HRP
64c2e6a0-2341-49c4-a6dd-656e7bb505dd	0	0	0	0	HRP	0	0	0	0	HRP
64dd81e1-35fa-4579-8a4c-f7486adbb949	2	5	10	17	HRP	1	11	10	22	HRP
64e5ee38-e5c6-4911-ad87-c50dd8e52f1b	0	0	0	0	HRP	0	0	0	0	HRP
64f696a6-58b2-40a8-b848-fd775cd52529	1	0	0	1	HRP	1	0	0	1	HRP
6507e084-c038-4ba6-a431-fb9a53190d5f	4	4	5	13	HRP	3	9	5	17	HRP
650fe009-da01-4717-89df-9c95fafe3d7e	1	2	4	7	HRP	0	2	4	6	HRP
6527aa5a-c622-11e3-bf01-24c6515278c0	4	1	7	12	HRP	2	3	7	12	HRP
654dba9f-cfe5-4121-97c7-868613cdef53	4	4	4	12	HRP	3	8	4	15	HRP
6551ec26-4166-4d4f-bee2-444ea2466978	2	2	1	5	HRP	1	2	1	4	HRP
65723119-bdfe-46f0-b629-c171023abd71	3	2	7	12	HRP	3	9	7	19	HRP
65be412d-46c3-4cbf-9b46-b35351e53065	27	19	28	74	HRD	19	30	28	77	HRD
65d2dbc3-a163-4696-b246-47a430e66572	6	5	5	16	HRP	5	6	5	16	HRP
65f702b8-c623-11e3-bf01-24c6515278c0	1	2	2	5	HRP	1	3	2	6	HRP
65f9a820-f026-4a10-8bb7-1fbc3b38321e	5	4	10	19	HRP	3	7	10	20	HRP
6622f932-c622-11e3-bf01-24c6515278c0	4	0	4	8	HRP	2	1	4	7	HRP
66290cc6-1f1f-4a0b-83d1-423952da4840	4	3	9	16	HRP	2	3	9	14	HRP
66701395-5a53-41bb-866b-3bbf08bc33ab	2	2	2	6	HRP	1	2	2	5	HRP
669f0e01-28f6-4ed8-bdb5-73f84ea28f78	24	17	16	57	HRD	17	39	16	72	HRD
66b4a1f3-480f-4050-96ac-920c1c080864	1	0	2	3	HRP	0	2	2	4	HRP
66d312fc-809d-428b-98e3-a29d211db35c	2	3	7	12	HRP	1	6	7	14	HRP
66eb4833-1b87-4fd9-a53d-26dc7ad6de29	0	0	0	0	HRP	0	0	0	0	HRP
670f971f-a525-4ef8-91ba-610cfbaeb914	3	3	6	12	HRP	3	10	6	19	HRP
67189cd8-c623-11e3-bf01-24c6515278c0	5	8	3	16	HRP	3	11	3	17	HRP
6726c157-f688-491d-8b56-35628645df89	11	5	10	26	HRP	6	14	10	30	HRP
674819dc-c622-11e3-bf01-24c6515278c0	5	3	7	15	HRP	3	8	7	18	HRP
675a5a32-b405-4f03-bfcd-756343d1dfaf	0	3	5	8	HRP	0	5	5	10	HRP
6763f295-f2bf-4975-bea5-c1a490d9a1fa	1	1	0	2	HRP	1	1	0	2	HRP
6764e0a2-7a78-45c1-9189-6001c6518ce4	36	23	28	87	HRD	31	59	28	118	HRD
6797443c-eb4a-4654-b957-c0056e5a4206	9	18	18	45	HRP	7	32	18	57	HRD
67a2e34f-454e-4253-8f22-262fc74d312c	0	0	0	0	HRP	0	0	0	0	HRP
67bb70b2-b6f8-4aa9-80ce-48829f9fec56	3	0	3	6	HRP	3	3	3	9	HRP
67f88cd9-ab77-4227-a8d7-5512246f9772	1	0	1	2	HRP	0	0	1	1	HRP
68054218-c623-11e3-bf01-24c6515278c0	11	10	10	31	HRP	7	14	10	31	HRP
681e2301-2057-40e4-ab63-934775d63faa	1	3	7	11	HRP	1	4	7	12	HRP
6821446e-8e76-46fe-b0b9-47feb46d2585	16	10	16	42	HRP	8	30	16	54	HRD
6847e993-1414-4e6f-a2af-39ebe218dd7c	1	0	1	2	HRP	0	0	1	1	HRP
68509ede-3dcf-4a6e-9af0-4a9bb4dfa567	13	6	14	33	HRP	8	14	14	36	HRP
6867811f-ac89-47da-b5dc-1270033c36e7	8	6	10	24	HRP	6	12	10	28	HRP
687baf0b-aed9-4ab2-adb6-556a1d177a24	3	2	8	13	HRP	2	3	8	13	HRP
68956108-2606-4696-b038-462b6c432398	1	0	1	2	HRP	1	0	1	2	HRP
68b7fdb1-22b5-4152-9e69-a41151640cd8	3	2	4	9	HRP	2	4	4	10	HRP
68ba1105-569a-4209-9b45-0e2d64931806	9	4	11	24	HRP	5	8	11	24	HRP
68c2a355-862c-4657-b296-5776ed8447b0	3	1	5	9	HRP	3	4	5	12	HRP
690e481c-c623-11e3-bf01-24c6515278c0	13	16	24	53	HRP	8	34	24	66	HRD
692dfa4f-45e5-4183-b5da-6650a1fbcabd	9	5	12	26	HRP	7	11	12	30	HRP
6947cd78-0a51-4949-8383-343f9122d953	1	1	0	2	HRP	0	2	0	2	HRP
6962bc97-fbb8-4220-a600-e3c251e245cb	11	9	21	41	HRP	5	27	21	53	HRD
69c3c88c-d51e-4e03-b96b-ec4f1a0faa2d	11	4	13	28	HRP	9	12	13	34	HRP
69d6142c-3a16-46c9-8bed-1f4edc267c4d	0	0	0	0	HRP	0	0	0	0	HRP
69dbe6ef-f5de-4c1f-b2f2-963dcb6ccd3e	4	2	5	11	HRP	3	4	5	12	HRP
69f37546-c622-11e3-bf01-24c6515278c0	6	4	6	16	HRP	4	4	6	14	HRP
69fe982d-6ab8-49b7-9efa-8349d60eb076	0	0	0	0	HRP	0	0	0	0	HRP
6a0d0c42-1884-4c6a-936a-678a822c0936	8	2	10	20	HRP	4	10	10	24	HRP
6a129b50-c623-11e3-bf01-24c6515278c0	6	10	12	28	HRP	5	19	12	36	HRP
6a7cdaf6-211e-4eb8-a70e-1153d69c45e4	23	8	22	53	HRP	15	24	22	61	HRD
6aa00162-6294-4ce7-b6b7-0c3452e24cd6	4	5	6	15	HRP	2	5	6	13	HRP
6aba73ff-81e0-4f8d-ad12-e3136196e814	0	0	0	0	HRP	0	0	0	0	HRP
6ad44218-d34e-4126-bf56-1be2140cd3fb	6	2	9	17	HRP	4	6	9	19	HRP
6b20f942-7b89-497c-8a2e-ccce74d20ca9	12	6	11	29	HRP	7	11	11	29	HRP
6b25a78f-20dc-4ccc-b4c0-f9885d16725d	11	10	20	41	HRP	5	20	20	45	HRP
6b50391f-d890-4ca0-b942-beab0f8bf1c9	8	12	12	32	HRP	3	21	12	36	HRP
6ba5f81a-b7a0-4c18-a112-2e11094eec85	4	2	3	9	HRP	3	3	3	9	HRP
6baee028-c622-11e3-bf01-24c6515278c0	13	12	15	40	HRP	7	17	15	39	HRP
6bbd66dd-efee-4d6e-b02f-f88e98526b82	9	7	8	24	HRP	6	9	8	23	HRP
6bd4bca3-e568-4d1b-8b42-401fdf13d751	1	3	3	7	HRP	0	6	3	9	HRP
6bdf00f6-670f-466e-87fb-e853e41f000e	11	8	9	28	HRP	9	10	9	28	HRP
6c306cbe-c623-11e3-bf01-24c6515278c0	2	2	6	10	HRP	1	9	6	16	HRP
6c31d730-1734-44ac-92b3-760981528723	6	7	17	30	HRP	6	20	17	43	HRP
6c642c0b-4dd0-406c-ac68-ea376802d61b	0	0	1	1	HRP	0	0	1	1	HRP
6c65cb6d-8c50-4c7c-bc84-eeebe09fbe01	13	5	24	42	HRP	11	30	24	65	HRD
6c884037-49f9-41c3-b0e5-9cbcd545aeb7	7	3	12	22	HRP	3	9	12	24	HRP
6c8e9197-fd16-4fed-bfda-e349cab26314	16	17	22	55	HRD	11	38	22	71	HRD
6c8f3dc9-21bf-4859-9599-231ac040eb7d	1	0	0	1	HRP	0	0	0	0	HRP
6ca5c1bb-275b-4d05-948a-3c6c7d03fab9	0	0	0	0	HRP	0	0	0	0	HRP
6ce42746-88aa-485f-a1c4-1759aad95914	5	7	13	25	HRP	3	15	13	31	HRP
6ce66be0-c623-11e3-bf01-24c6515278c0	3	1	8	12	HRP	2	3	8	13	HRP
6cfce053-bfd6-4ca0-b74b-b2e4549e4f1f	0	0	1	1	HRP	0	0	1	1	HRP
6d0851ba-271a-408f-bcc3-c104b452c9e5	5	8	0	13	HRP	2	10	0	12	HRP
6d2a5ee7-9e46-4c09-a982-7b61b5d9bdea	1	2	7	10	HRP	1	8	7	16	HRP
6d325c96-8f5c-4064-9806-4364016da8a4	0	1	0	1	HRP	0	2	0	2	HRP
6d3551d6-b5f4-4fd1-b8d7-8e5931096c19	1	3	2	6	HRP	1	6	2	9	HRP
6d3d5531-16b4-46ec-bd7e-394946855d62	2	2	4	8	HRP	1	2	4	7	HRP
6d4a548a-7e30-4b6b-9a13-72827eed439c	2	3	13	18	HRP	1	9	13	23	HRP
6d7f44df-e9f0-4542-a6d8-d14ee7804002	4	1	11	16	HRP	1	7	11	19	HRP
6d936ef9-b5df-44d3-831f-528bf8ddc131	1	2	0	3	HRP	1	2	0	3	HRP
6d9d7ffc-c622-11e3-bf01-24c6515278c0	3	8	15	26	HRP	2	9	15	26	HRP
6dac8ca0-f776-4ea2-85c4-aefba4966be7	18	9	18	45	HRP	13	22	18	53	HRD
6dbac113-d4cf-4db5-97c9-50fa400bb47e	9	9	23	41	HRP	5	21	23	49	HRP
6dbc5c31-043b-40e9-bf1a-e7b4ec351b4d	3	8	12	23	HRP	3	11	12	26	HRP
6dc43234-4f07-4c53-8b07-8d78d9dbad3b	4	2	3	9	HRP	3	3	3	9	HRP
6de41ac1-229b-40b9-a494-5588c284351d	4	1	5	10	HRP	3	7	5	15	HRP
6e26f98e-c623-11e3-bf01-24c6515278c0	4	4	2	10	HRP	2	7	2	11	HRP
6e516c4b-fee7-4336-8470-494588e645b3	0	0	1	1	HRP	0	0	1	1	HRP
6e599fcc-d79a-4e0f-b451-c20768c989f9	11	7	10	28	HRP	5	9	10	24	HRP
6e6ad1a2-f1eb-44d1-9852-f5752afcf5eb	10	15	24	49	HRP	9	26	24	59	HRD
6e776415-ddf4-4060-953f-08ef22441234	18	4	13	35	HRP	12	12	13	37	HRP
6e839eaf-1dbb-43f5-8846-c980e05540c7	20	17	28	65	HRD	16	57	28	101	HRD
6ea6b5e4-cdc4-4e3a-bde2-8089d2a4d7eb	0	1	2	3	HRP	0	2	2	4	HRP
6ec4456e-c622-11e3-bf01-24c6515278c0	10	2	11	23	HRP	5	3	11	19	HRP
6f25ca85-4b4a-420f-b0cc-5a4f65a97da3	2	4	0	6	HRP	0	8	0	8	HRP
6f395380-c623-11e3-bf01-24c6515278c0	5	11	19	35	HRP	4	18	19	41	HRP
6f4d836f-e86f-4b12-9549-7117f59e3d4a	1	1	0	2	HRP	1	1	0	2	HRP
6f981023-4269-4e8e-a4ab-2c92bb27273c	21	19	20	60	HRD	14	34	20	68	HRD
6fc0cb07-9713-4355-8543-f85d1c5505c2	10	4	13	27	HRP	7	11	13	31	HRP
6fe135ef-54b4-4941-9bb9-872dc4d18d9f	4	2	2	8	HRP	4	5	2	11	HRP
6ff16b0d-5966-4119-9bec-c9ebff804a37	0	0	1	1	HRP	0	1	1	2	HRP
6fffe0cf-bb38-4e77-88ab-a256bd7fbbce	28	27	30	85	HRD	25	73	30	128	HRD
7034e5f6-c623-11e3-bf01-24c6515278c0	5	6	6	17	HRP	3	8	6	17	HRP
70422e6d-cb1f-4284-8be9-1d4517ffad60	4	3	14	21	HRP	3	7	14	24	HRP
706868b5-4920-433a-bea3-92e9bf83059b	30	12	20	62	HRD	23	27	20	70	HRD
706a1085-5994-4d04-b56b-d301c9ed5afa	1	2	1	4	HRP	0	2	1	3	HRP
7087a2b6-7fc4-45b0-8c48-248864f03deb	1	0	0	1	HRP	0	1	0	1	HRP
708e21ac-f529-4461-bc4f-d3a194a92b80	34	9	21	64	HRD	25	24	21	70	HRD
70990332-7702-45e2-84cb-8bbff773f160	1	1	3	5	HRP	1	1	3	5	HRP
70c2f91e-c622-11e3-bf01-24c6515278c0	2	0	4	6	HRP	1	0	4	5	HRP
70dd8453-11d3-4105-a8d0-6a755c52495d	11	4	7	22	HRP	10	5	7	22	HRP
7116cc90-f465-4e7e-aa27-48a83ed258e9	21	9	12	42	HRP	13	15	12	40	HRP
7117854b-6f0a-4a43-b66c-506a3e29377d	11	13	14	38	HRP	10	19	14	43	HRP
711c8a16-3cf8-42d8-b29e-fd1e9ef1c82b	1	0	2	3	HRP	0	0	2	2	HRP
712ba532-fb1a-43fa-a356-b446b509ceb7	0	0	0	0	HRP	0	0	0	0	HRP
712e5f3c-c623-11e3-bf01-24c6515278c0	4	3	1	8	HRP	3	9	1	13	HRP
7158c9fd-a633-4fef-aa23-bd285f2a87a8	1	2	4	7	HRP	0	3	4	7	HRP
715f59dd-a80f-422d-988c-f73f4b987baf	0	1	2	3	HRP	0	3	2	5	HRP
7163a0f7-2c69-40b8-8857-8ab3f46f0acf	6	1	4	11	HRP	4	3	4	11	HRP
7181dd10-1371-4cb6-9219-a9542c62b854	7	4	2	13	HRP	5	18	2	25	HRP
718c5a31-6b19-4f68-9fb9-79b0c00d64a5	0	0	0	0	HRP	0	0	0	0	HRP
71982a1b-52a4-440f-bd5d-62a0e6cc7fd9	2	2	2	6	HRP	2	9	2	13	HRP
71a2b4a2-88dd-4911-a67e-70b3309c4a12	20	16	24	60	HRD	16	36	24	76	HRD
71ef8379-03a0-4b81-92c9-1ba666fe4d7a	4	1	4	9	HRP	3	3	4	10	HRP
71fda5a9-7049-406f-9348-2c24f7ddf5f4	41	21	24	86	HRD	31	50	24	105	HRD
72108583-5320-46ec-945f-5ff173d7dc15	22	8	15	45	HRP	14	19	15	48	HRP
72293a70-9dc8-4e4a-acdc-c74587a90420	1	0	0	1	HRP	0	0	0	0	HRP
7243992d-0763-4b75-8066-e8e5309d0193	0	0	1	1	HRP	0	0	1	1	HRP
724bf2b8-a246-4b6f-85f8-95824c03896e	1	0	1	2	HRP	0	1	1	2	HRP
7260f57c-c623-11e3-bf01-24c6515278c0	3	0	4	7	HRP	2	4	4	10	HRP
7266ec7b-4824-4b88-910e-e9bfb848d55f	10	4	8	22	HRP	6	7	8	21	HRP
729229fe-92b9-439b-acd2-b49159116a41	3	1	1	5	HRP	3	2	1	6	HRP
72a27124-24b9-41f7-a065-774fdf5f7d19	1	1	1	3	HRP	1	1	1	3	HRP
72a5e569-99d4-47bc-be1b-6296a5025080	3	4	3	10	HRP	2	6	3	11	HRP
72b62805-76f9-476a-b876-a781e69a2c90	0	0	0	0	HRP	0	0	0	0	HRP
72c22a8c-c622-11e3-bf01-24c6515278c0	5	1	5	11	HRP	5	5	5	15	HRP
72f0a49a-aec8-47e5-846a-956c4da1507c	9	8	19	36	HRP	8	34	19	61	HRD
72f82fbd-9838-4082-b605-bc3d80226f16	12	11	21	44	HRP	6	15	21	42	HRP
7303f9fe-88bb-48ba-b9b4-ebf9e4770c1c	4	1	15	20	HRP	4	11	15	30	HRP
73058c80-607e-4b55-b112-8f8f6775d014	10	3	10	23	HRP	9	5	10	24	HRP
734a8251-9ecc-47f5-835f-846b67693ca6	2	1	4	7	HRP	1	1	4	6	HRP
7364a112-61b9-41c6-b85f-18c97c54cefd	0	1	2	3	HRP	0	1	2	3	HRP
73936e8b-c893-4afd-bd1f-be90c06a4869	8	3	20	31	HRP	7	13	20	40	HRP
73afad06-c623-11e3-bf01-24c6515278c0	6	5	8	19	HRP	5	20	8	33	HRP
73f7718b-f9b1-4a63-a561-0c9cc2abeb9f	0	0	0	0	HRP	0	0	0	0	HRP
74039acd-5aca-4c65-818c-3b577d295be0	2	2	13	17	HRP	2	7	13	22	HRP
7410c00d-ed0b-48dc-a4bf-eb76ac613980	15	7	20	42	HRP	14	14	20	48	HRP
741c4656-0fd0-416e-86c8-f6533b6c96f4	0	0	2	2	HRP	0	1	2	3	HRP
7456abd5-303e-4e6f-bf4e-47efefc7310f	26	18	29	73	HRD	19	33	29	81	HRD
745b8756-0eab-423f-8cde-e0ff1aaa6596	5	5	13	23	HRP	2	16	13	31	HRP
748d3ff3-8699-4519-8e0f-26b6a0581bff	11	3	12	26	HRP	6	8	12	26	HRP
74b57d2c-a83f-4798-b86b-a533975e4cc0	40	9	30	79	HRD	38	41	30	109	HRD
74db46a8-a499-4951-af33-1d53b7d1c9b4	0	0	0	0	HRP	0	0	0	0	HRP
74e5905f-6350-498a-9454-9ea0593d2f56	5	5	17	27	HRP	4	16	17	37	HRP
74ec279a-c622-11e3-bf01-24c6515278c0	3	6	13	22	HRP	2	8	13	23	HRP
7512b38c-c623-11e3-bf01-24c6515278c0	11	12	12	35	HRP	8	22	12	42	HRP
754d26af-f184-497c-856a-cd1ea7a5115c	6	2	7	15	HRP	5	12	7	24	HRP
759d30b2-ddb8-49e2-a604-57ff9222d3a0	0	0	0	0	HRP	0	0	0	0	HRP
759e20be-6a2b-4c54-aca0-6d358598d6f5	0	1	2	3	HRP	0	1	2	3	HRP
75ad15b9-8f9c-40c1-9ca6-1e8454fbd310	14	6	15	35	HRP	5	17	15	37	HRP
75ba6722-1148-4a52-a9ed-68d890238205	15	7	14	36	HRP	10	19	14	43	HRP
75cd90ef-e884-4812-bbf3-5a524d95147e	13	6	8	27	HRP	10	9	8	27	HRP
75e1bdbc-474e-4367-9b4a-963b31f3b297	0	1	3	4	HRP	0	1	3	4	HRP
75fac59c-3346-4c5a-bb9f-fb67fec8d13b	18	16	21	55	HRD	6	20	21	47	HRP
760881cc-c623-11e3-bf01-24c6515278c0	3	2	2	7	HRP	2	3	2	7	HRP
7625877a-7a2b-466f-944b-9e56689ad47b	15	6	14	35	HRP	10	18	14	42	HRP
764ded9e-c622-11e3-bf01-24c6515278c0	5	2	6	13	HRP	1	5	6	12	HRP
767517f2-f94c-44bb-9af6-36b662b166ef	0	0	0	0	HRP	0	0	0	0	HRP
76788f17-257d-47c7-ad85-ac5f959216b5	0	0	0	0	HRP	0	0	0	0	HRP
769e2ac9-a121-4b2a-a0fd-5f755b579811	1	2	0	3	HRP	0	2	0	2	HRP
76a0d9c9-5e69-44e8-9ed2-6d2e387803fc	8	9	11	28	HRP	5	14	11	30	HRP
7731ef7f-25bd-42f5-9a20-be249306a711	14	5	19	38	HRP	11	17	19	47	HRP
7789ef18-c623-11e3-bf01-24c6515278c0	22	26	24	72	HRD	20	50	24	94	HRD
77bf9514-88da-473b-9a91-f669ef3cd343	1	8	4	13	HRP	1	10	4	15	HRP
77c022d3-2f29-49d3-a1df-cc2e9407fd7f	41	11	27	79	HRD	34	30	27	91	HRD
77ebe6d2-6537-49d3-849d-fe93e2cf52af	0	0	0	0	HRP	0	0	0	0	HRP
78100212-65aa-4365-8b64-4b33f77732d5	9	1	9	19	HRP	4	6	9	19	HRP
78103d9b-0b8a-431e-bb58-5c99fbea12e4	11	25	19	55	HRD	7	44	19	70	HRD
7815397b-aa39-4b79-bcaa-6859a3f115f8	0	0	0	0	HRP	0	0	0	0	HRP
783579bd-e29d-457c-8236-1a80b557600c	6	10	0	16	HRP	5	14	0	19	HRP
7866dfb2-46b3-42b4-905b-12f80593d6bd	17	16	22	55	HRD	14	41	22	77	HRD
786fc3e4-e2bf-4914-9251-41c800ebb2fa	10	10	10	30	HRP	8	15	10	33	HRP
78bc2608-c623-11e3-bf01-24c6515278c0	9	3	5	17	HRP	6	9	5	20	HRP
78bc4dfa-c622-11e3-bf01-24c6515278c0	6	3	7	16	HRP	6	5	7	18	HRP
78bd2aa8-e5f6-4b4b-96f0-d406fbdbcee8	5	2	4	11	HRP	5	7	4	16	HRP
79133e29-ba0b-4e2f-a6d9-bf294c5144f0	0	0	0	0	HRP	0	0	0	0	HRP
79169c46-7049-4576-9885-63973db76ab9	0	0	0	0	HRP	0	0	0	0	HRP
79353875-9d86-4063-a8ea-1d998acb1e81	3	4	1	8	HRP	3	7	1	11	HRP
79524d64-8f4a-4889-b345-33198808b9de	1	2	2	5	HRP	0	2	2	4	HRP
796a8782-6d7e-47c8-b322-fcfe1dd240c8	5	3	5	13	HRP	2	4	5	11	HRP
7981bbf3-dceb-4d89-900c-555967e97921	8	3	11	22	HRP	5	6	11	22	HRP
79914ce9-04d8-4b0d-9f16-2e528044966e	3	3	2	8	HRP	3	6	2	11	HRP
79b23f34-c623-11e3-bf01-24c6515278c0	9	9	6	24	HRP	5	10	6	21	HRP
79e81ab3-5466-4324-9387-2de00d62315c	1	2	1	4	HRP	1	3	1	5	HRP
79eb7bba-f0d8-462c-add7-20a2fb7843e1	20	8	19	47	HRP	11	16	19	46	HRP
79fa8423-2014-4536-a1f9-cb48aed3c45f	0	1	2	3	HRP	0	1	2	3	HRP
7a4f6014-f7a2-459b-bc43-df164e73cbba	12	9	22	43	HRP	9	27	22	58	HRD
7a5d3b6b-be5a-4e55-9255-32a069b8af3d	1	5	4	10	HRP	1	16	4	21	HRP
7a6cb147-a576-446d-a605-fa846ea3d1ad	1	1	6	8	HRP	0	6	6	12	HRP
7a86abdc-d554-43bd-ad47-22d439c930ef	1	1	0	2	HRP	1	2	0	3	HRP
7a921087-8e62-4a93-a757-fd8cdbe1eb8f	20	21	21	62	HRD	14	36	21	71	HRD
7a95af21-ca7c-4596-9c83-66d11ca0c417	2	1	2	5	HRP	1	1	2	4	HRP
7ac0b303-d685-4fa5-bfec-34d2ba1dbc8e	17	10	24	51	HRP	12	32	24	68	HRD
7ac3e543-3bc2-4a59-84fc-b5aa0def592c	1	0	2	3	HRP	0	0	2	2	HRP
7adcea71-1aed-450c-b0ff-b9d9820c6153	12	9	14	35	HRP	9	21	14	44	HRP
7ae3671f-bf98-4693-8f35-3b762c9121d4	1	0	1	2	HRP	0	1	1	2	HRP
7ae510f8-c622-11e3-bf01-24c6515278c0	1	2	4	7	HRP	0	3	4	7	HRP
7ae872a6-c623-11e3-bf01-24c6515278c0	6	5	7	18	HRP	3	7	7	17	HRP
7ae9b843-488f-459c-8c0d-c81dcae57f99	1	6	5	12	HRP	1	10	5	16	HRP
7b08e810-f3c9-4155-ac11-f45a3a4f8b41	14	21	22	57	HRD	7	36	22	65	HRD
7b0b60c7-5fa0-440e-937f-8d82119330d6	2	1	7	10	HRP	1	1	7	9	HRP
7b296706-b535-45a0-9a8e-4a34a8c33bb5	0	0	0	0	HRP	0	0	0	0	HRP
7b318282-5df4-42bc-b1e0-0e4a66ba9204	9	3	7	19	HRP	8	6	7	21	HRP
7b482f46-adcc-48ae-a4d6-17f4edd998dc	1	2	6	9	HRP	1	6	6	13	HRP
7ba70717-d65e-4a45-af79-60a976770526	5	4	10	19	HRP	5	11	10	26	HRP
7bc3209f-b349-49bf-9b3d-44ef870b586f	6	0	9	15	HRP	3	1	9	13	HRP
7bd3d112-d411-4ea8-a9a9-bd965f0fc943	1	3	3	7	HRP	0	4	3	7	HRP
7bd4d5e2-69ee-4264-93e4-2ba01418c460	1	1	15	17	HRP	1	2	15	18	HRP
7bdcb78a-c623-11e3-bf01-24c6515278c0	1	0	1	2	HRP	1	0	1	2	HRP
7c405ca0-c622-11e3-bf01-24c6515278c0	3	1	4	8	HRP	1	1	4	6	HRP
7c43c006-d917-4915-b304-65995b6c0d46	5	2	9	16	HRP	5	5	9	19	HRP
7c477f01-8000-49dc-a692-e47fc15e0b4f	4	1	0	5	HRP	0	2	0	2	HRP
7c5c2293-3f40-4ae3-8346-6a327b2abf4d	25	17	16	58	HRD	18	40	16	74	HRD
7cae6c0b-36fe-411b-bbba-093a4c846d84	6	7	10	23	HRP	5	13	10	28	HRP
7cb71498-6ada-43c6-912b-bad4f93cf580	15	21	20	56	HRD	9	32	20	61	HRD
7ccb9a4d-6f48-41c2-a630-27fde8c67d60	5	2	13	20	HRP	3	2	13	18	HRP
7ccee959-1e87-4a39-b6b3-840ddcb94995	12	14	16	42	HRP	10	28	16	54	HRD
7cd7fe38-c623-11e3-bf01-24c6515278c0	7	5	10	22	HRP	5	11	10	26	HRP
7cdbe0e8-f614-4f54-b864-fd6b39e8ef1c	4	1	6	11	HRP	3	8	6	17	HRP
7d04f401-3505-410c-8def-0348ecd8aae2	4	2	13	19	HRP	4	5	13	22	HRP
7d2a22eb-7344-4cba-ad7d-94c3f9ef3d7c	1	0	1	2	HRP	1	1	1	3	HRP
7d2da7ba-f57c-4083-9572-6fa98008083b	15	8	11	34	HRP	10	17	11	38	HRP
7d332cb1-ba25-47e4-8bf8-d25e14f40d59	1	8	23	32	HRP	1	28	23	52	HRP
7d38018a-c622-11e3-bf01-24c6515278c0	3	2	5	10	HRP	2	3	5	10	HRP
7d52a9e7-b5a9-4519-96fd-e8be42a7890c	0	0	0	0	HRP	0	0	0	0	HRP
7d59205a-65ec-4341-9748-28639d82ed29	3	2	2	7	HRP	2	2	2	6	HRP
7d6fb1a7-7742-4b8c-9903-abff706240b5	3	3	2	8	HRP	1	7	2	10	HRP
7d734d06-f2b1-4924-a201-620ac8084c49	1	0	2	3	HRP	1	4	2	7	HRP
7d7fff91-3f69-4123-b514-140ed3d9cd66	5	1	6	12	HRP	3	2	6	11	HRP
7dc3e035-c7ae-4164-a62b-9c2460812b05	8	5	9	22	HRP	4	8	9	21	HRP
7dc5f8ba-0080-43d3-8426-bd527a970761	27	15	29	71	HRD	21	33	29	83	HRD
7dd2dc62-0eb4-4d45-86f1-e9e9377181ca	10	10	2	22	HRP	7	18	2	27	HRP
7dddd413-d2c6-4f75-bbf6-3b202877546e	0	0	0	0	HRP	0	0	0	0	HRP
7df3a542-c623-11e3-bf01-24c6515278c0	4	7	8	19	HRP	3	18	8	29	HRP
7dfcfe29-3900-4d7b-8067-60c51584b0b1	0	0	0	0	HRP	0	0	0	0	HRP
7e036d40-b669-4929-a1e2-c4736e01a473	26	8	18	52	HRP	20	27	18	65	HRD
7e10e325-16d2-42df-b957-df4d3a9477d0	6	2	6	14	HRP	3	6	6	15	HRP
7e22401d-f4cd-44c5-8a01-b08a439e5a31	6	3	9	18	HRP	3	8	9	20	HRP
7e305f31-fbb0-4bce-894b-1dd85e303421	0	0	0	0	HRP	0	0	0	0	HRP
7e4d570e-f26b-41fb-84c5-2a6f7d668bb5	3	5	0	8	HRP	2	11	0	13	HRP
7e584ff6-0b81-4f85-81da-b8117afee326	13	7	19	39	HRP	7	17	19	43	HRP
7eac4710-c622-11e3-bf01-24c6515278c0	8	8	13	29	HRP	6	14	13	33	HRP
7eb0ee38-fbe2-49ea-ba63-aa13825eca6e	4	9	9	22	HRP	3	12	9	24	HRP
7eb0f792-858f-45d1-a908-125b02ea1506	12	9	18	39	HRP	5	20	18	43	HRP
7edc42d3-d08e-4360-a3e1-aeb57cfc6640	19	9	19	47	HRP	13	35	19	67	HRD
7ef9fd9b-d349-4ec3-ab4d-1a1d11c0204b	6	7	7	20	HRP	4	7	7	18	HRP
7f031d71-3cb7-4744-86bd-a3beecfe166e	5	7	13	25	HRP	2	18	13	33	HRP
7f03cb4b-60b1-460c-b761-402e7ca09b0d	0	1	1	2	HRP	0	1	1	2	HRP
7f22b0f7-4040-4c84-939e-894c3050ef5d	1	0	1	2	HRP	1	0	1	2	HRP
7f42e118-aab6-438a-9e84-e7451fe12d7e	8	3	11	22	HRP	4	9	11	24	HRP
7f5fd36f-6e30-45ca-92a5-d8a8a8ee1bc2	24	14	22	60	HRD	18	22	22	62	HRD
7f795952-c623-11e3-bf01-24c6515278c0	3	3	4	10	HRP	1	4	4	9	HRP
7f7e007e-4b06-4328-b116-6dcdb2ad8181	0	0	0	0	HRP	0	0	0	0	HRP
7f9382a5-f6da-4fe8-93ad-6adc91f508fa	0	0	0	0	HRP	0	0	0	0	HRP
7f94d650-41b9-4664-bcde-dc8533e4602d	10	9	12	31	HRP	8	12	12	32	HRP
7fba5aac-c622-11e3-bf01-24c6515278c0	2	1	15	18	HRP	1	4	15	20	HRP
7fc7b316-f3d3-4e71-9417-423fe334e6bc	12	10	10	32	HRP	10	17	10	37	HRP
7fcd8af9-4d73-4c97-95cc-b30b09f21bb2	11	4	8	23	HRP	6	7	8	21	HRP
7fdd07a4-4a27-40c3-af92-a0074e6391f5	13	8	16	37	HRP	7	13	16	36	HRP
7fe96e71-436d-49d4-9e47-e104e1203568	6	5	3	14	HRP	4	14	3	21	HRP
801e67c8-c506-410a-bdf0-856a66e974f4	20	12	24	56	HRD	13	28	24	65	HRD
8044a282-bc2c-47c6-8a85-53c3b5eeb08f	0	0	0	0	HRP	0	0	0	0	HRP
804ffa2e-158b-447d-945c-707684134c87	3	0	3	6	HRP	2	2	3	7	HRP
8093649a-74d6-4832-9154-8cc0182fa381	7	10	20	37	HRP	5	22	20	47	HRP
80ab6c08-c622-11e3-bf01-24c6515278c0	0	0	0	0	HRP	0	0	0	0	HRP
80ebcecc-4a7a-40dd-914c-f0648a58095f	10	1	7	18	HRP	6	5	7	18	HRP
80f02aec-c07a-4bcb-b547-e60f8c33a7b1	23	18	24	65	HRD	16	36	24	76	HRD
81598359-24d5-4a8b-a6e6-7a6f94289119	3	3	10	16	HRP	3	9	10	22	HRP
819b4304-c622-11e3-bf01-24c6515278c0	3	4	3	10	HRP	2	4	3	9	HRP
81a8b064-e735-455f-b2db-af7ae11daac4	8	19	19	46	HRP	6	42	19	67	HRD
81b1e78c-6032-4ff4-b52a-83456b9450ea	5	5	11	21	HRP	2	8	11	21	HRP
81b4dd02-34ec-4ddc-8818-ed888a60ad88	1	0	2	3	HRP	0	0	2	2	HRP
81bb13fc-f082-4c0b-8066-1729f11ef617	2	0	0	2	HRP	0	0	0	0	HRP
81bc7f0c-865d-4801-a935-2ab04170df53	14	23	16	53	HRP	9	32	16	57	HRD
81c7a8c1-8a6a-4e78-a72c-f7c021c67ff7	1	0	2	3	HRP	1	0	2	3	HRP
81cc0f39-6677-4f2e-9a75-d30152b188f3	3	4	5	12	HRP	3	5	5	13	HRP
81d0d6bb-7319-4b67-bcf7-36df24e76b43	1	3	2	6	HRP	1	4	2	7	HRP
8282283d-247a-431d-9421-0fcc52f0a897	18	15	14	47	HRP	11	30	14	55	HRD
8294a969-59a1-4d3b-895b-f07e96bf9f7a	3	3	6	12	HRP	2	3	6	11	HRP
82aefe8e-c622-11e3-bf01-24c6515278c0	1	3	4	8	HRP	0	3	4	7	HRP
82b8cda8-fbff-455e-b0db-7ff6528bd6c8	10	12	19	41	HRP	7	18	19	44	HRP
82be6087-a491-42d4-9b48-6a10d1bace18	10	8	19	37	HRP	6	26	19	51	HRP
82d2ea5f-ebdc-4907-a287-fe837fd6b59c	18	5	15	38	HRP	16	23	15	54	HRD
82d7fa2d-19cd-41b7-8ed1-ea9fb9a544c6	2	2	1	5	HRP	1	4	1	6	HRP
836ec5a5-e385-4236-83e7-2641ee35db7f	5	3	6	14	HRP	2	6	6	14	HRP
83a1b304-2ec1-44ae-a9c5-8ad3a2a46a1f	5	4	6	15	HRP	4	8	6	18	HRP
83d57c5c-c622-11e3-bf01-24c6515278c0	2	1	3	6	HRP	0	1	3	4	HRP
83eca7b5-45bb-44c0-8afe-36f8988d0078	10	7	15	32	HRP	4	16	15	35	HRP
8404ef5b-7a64-47fe-98f9-3f63619d2d99	1	3	4	8	HRP	1	4	4	9	HRP
841eb82b-347d-4d7f-805f-3f3701a2983d	4	0	4	8	HRP	4	3	4	11	HRP
842df341-d34f-4ed6-928c-eaf15bf7f667	6	8	6	20	HRP	4	11	6	21	HRP
8454fe53-869d-41c8-b0c8-a7929d00eec3	16	4	18	38	HRP	13	15	18	46	HRP
84a0bc36-9f29-4b23-aee1-bf5ff71f697b	3	6	20	29	HRP	1	7	20	28	HRP
84a6ea88-eeb8-4060-a90c-e4abac013ad4	11	17	16	44	HRP	10	25	16	51	HRP
84aa2983-714b-49fd-af93-f18ed4d6a6cb	3	5	3	11	HRP	3	7	3	13	HRP
84ae4dd8-f661-46aa-9892-69742e2f3542	1	2	2	5	HRP	1	4	2	7	HRP
84c77098-03d0-4b22-afb1-797703e85c6c	11	11	22	44	HRP	7	26	22	55	HRD
84ca6ab0-9edc-4636-9d27-55cdba334d7d	27	4	30	61	HRD	25	30	30	85	HRD
84e601b7-dfa5-4cd5-9fef-07f03967a0d4	19	8	21	48	HRP	12	24	21	57	HRD
84fe77b4-f6cc-49bf-a6b9-1621ec9394f8	5	8	7	20	HRP	4	12	7	23	HRP
850389d4-c622-11e3-bf01-24c6515278c0	4	3	7	14	HRP	3	4	7	14	HRP
85422a8e-2599-4dab-a257-150e380ecba8	0	1	1	2	HRP	0	1	1	2	HRP
85448d11-9f84-44b7-8ae3-a115f24bdb76	2	0	4	6	HRP	1	1	4	6	HRP
857a8354-9589-424e-98f4-98b9bfd6dcb0	0	2	0	2	HRP	0	2	0	2	HRP
858631eb-4e91-4aad-809c-c3948519313d	7	7	15	29	HRP	4	17	15	36	HRP
85d915b8-0184-4ec7-93ad-e9ffa2f5743b	2	2	1	5	HRP	0	2	1	3	HRP
85e29049-a5e8-49fa-a576-e113c7b2c2e3	4	3	12	19	HRP	2	7	12	21	HRP
85ed2434-da94-4333-90ca-6ca4691cbdd3	2	1	0	3	HRP	1	3	0	4	HRP
86386b36-2950-4479-b79f-4b347053c8bc	2	0	1	3	HRP	0	0	1	1	HRP
8658f4f5-9a50-4195-8ea3-227951977647	32	14	23	69	HRD	20	35	23	78	HRD
8659a35e-c622-11e3-bf01-24c6515278c0	4	8	10	22	HRP	2	11	10	23	HRP
866ecfe7-caa6-4565-9418-6b9d6c8a3b43	1	1	1	3	HRP	1	4	1	6	HRP
86874a67-aa86-45f1-be32-3b2722ebedec	5	2	1	8	HRP	4	13	1	18	HRP
8689b53c-8883-479c-85f6-d13b86272b5d	7	4	1	12	HRP	6	6	1	13	HRP
868c95ad-45df-4f8e-9553-b7c2c5679deb	0	3	3	6	HRP	0	3	3	6	HRP
8691c87f-2468-44bb-a670-3dccd6da33c6	9	4	10	23	HRP	5	9	10	24	HRP
86ae34f9-e16a-4593-8e55-b1296782bc1f	1	3	2	6	HRP	1	3	2	6	HRP
86cbb7ad-b22b-414f-a122-77d38c77207d	0	0	0	0	HRP	0	0	0	0	HRP
86f23897-dba0-4e89-8381-d174eaa6fcc1	18	16	31	65	HRD	17	46	31	94	HRD
870e7aa5-a9c2-4c4e-afa8-36bb3bdc4eee	1	1	1	3	HRP	0	1	1	2	HRP
873ed251-fa44-465f-99e0-c90a42ea13d9	1	0	1	2	HRP	1	0	1	2	HRP
874f64e9-8a0d-4f88-92c4-7e831842b1d1	1	2	1	4	HRP	0	3	1	4	HRP
87671312-c622-11e3-bf01-24c6515278c0	6	2	9	17	HRP	5	7	9	21	HRP
878a7fe7-20ff-4651-9587-b4d6fd42e929	6	7	13	26	HRP	6	18	13	37	HRP
87e0b332-60f3-4d59-8c4e-691a820c9ee1	0	2	2	4	HRP	0	2	2	4	HRP
87e1ffee-a8cd-4d75-937e-ed415cf43546	6	6	6	18	HRP	5	10	6	21	HRP
880e6970-0131-4966-b13e-8614d33f0df7	1	2	4	7	HRP	1	3	4	8	HRP
88395c0e-4afe-434d-8b20-5a3eef8b7f00	1	0	2	3	HRP	1	1	2	4	HRP
8845fce6-e2b4-4929-942b-57096b0bbafc	2	2	6	10	HRP	1	4	6	11	HRP
8853cbee-7931-49a6-b063-a806943a10ad	0	0	0	0	HRP	0	0	0	0	HRP
8867bdef-3a8d-433e-b10f-d752e2cbb022	46	15	32	93	HRD	41	57	32	130	HRD
887616c5-06a7-4e83-948c-3546202349fb	4	4	3	11	HRP	4	8	3	15	HRP
8888e808-594b-4c76-b2e4-62aa56736f7c	27	18	30	75	HRD	24	49	30	103	HRD
889fb525-5055-4408-a12e-17f1225c9d29	4	6	7	17	HRP	2	7	7	16	HRP
88bc38ba-ad1d-431e-a67e-0a5a23678386	11	5	11	27	HRP	7	12	11	30	HRP
88d5a8b2-daba-45ce-90bf-480fac85bf1d	7	6	8	21	HRP	5	9	8	22	HRP
88d82a42-c622-11e3-bf01-24c6515278c0	5	6	8	19	HRP	4	8	8	20	HRP
88e35d25-d98d-4576-8ebe-1cd74010ecd8	4	8	10	22	HRP	2	9	10	21	HRP
88f2c496-3eb4-4c03-b3a5-8d5a55803aaf	7	8	8	23	HRP	6	10	8	24	HRP
890e840c-1d1d-4874-a8eb-f9d9a2b50a1c	5	5	5	15	HRP	5	15	5	25	HRP
89195d56-1ef2-41df-b200-9f18e38f574a	12	9	20	41	HRP	10	16	20	46	HRP
8930735a-4eb4-4489-8513-d4b600c316ab	1	2	0	3	HRP	1	4	0	5	HRP
897a4500-6fb8-4e81-aa07-021a26d632fb	5	11	12	28	HRP	4	19	12	35	HRP
897ba508-d74b-46bf-8554-1210a66a36d1	15	5	7	27	HRP	9	5	7	21	HRP
89c48e53-c8a9-4518-b3b8-509cdcaff52b	8	7	13	28	HRP	4	13	13	30	HRP
89dad92e-5b3f-479a-a6da-a94ee7df7f8a	25	2	19	46	HRP	17	54	19	90	HRD
89f34810-19c6-47bc-981d-98498b013686	0	0	0	0	HRP	0	0	0	0	HRP
8a2580c3-9c89-4cb0-b94d-3eca15dac1c3	3	7	11	21	HRP	2	15	11	28	HRP
8a69f3ca-4e17-4daa-8722-a36316e345ba	23	26	27	76	HRD	20	41	27	88	HRD
8a6d6b2e-c622-11e3-bf01-24c6515278c0	1	0	1	2	HRP	0	3	1	4	HRP
8a8dd718-c46e-462a-9793-83d88f5caa7f	6	3	5	14	HRP	3	6	5	14	HRP
8a929c55-35a6-4645-bb70-4b85d281b139	1	2	5	8	HRP	1	2	5	8	HRP
8a9359de-b0ad-4a2d-a543-e3b982697db9	1	0	0	1	HRP	1	2	0	3	HRP
8b0c4c91-2d07-4a9b-97a1-d2bda003437e	4	4	6	14	HRP	4	8	6	18	HRP
8b28f6d2-4b7d-493b-826e-b119a4fb0cb4	33	11	25	69	HRD	25	36	25	86	HRD
8bbe4006-be0a-4cd5-91f6-529100d4f06e	2	2	2	6	HRP	1	3	2	6	HRP
8bda75a6-86b9-458e-948b-05049b4c52ce	1	2	9	12	HRP	1	12	9	22	HRP
8be2b0f5-7bad-4720-b13c-e95b32bdb933	28	9	17	54	HRD	21	21	17	59	HRD
8be6b14d-286a-471b-a282-ab98bc6050c3	9	3	10	22	HRP	7	6	10	23	HRP
8c0a7dfa-6ec3-4262-b718-c3605722df37	2	4	1	7	HRP	1	6	1	8	HRP
8c233a11-3b2e-4273-bbe1-b5a5f5a351d5	11	2	10	23	HRP	7	7	10	24	HRP
8c4038b6-c02a-46db-9514-c13b88d9bf48	0	0	0	0	HRP	0	0	0	0	HRP
8c443bd0-7987-44de-b312-5b859e6d13a9	1	0	1	2	HRP	1	2	1	4	HRP
8c46a1df-1c10-4188-992a-a55b782494c9	1	0	1	2	HRP	0	4	1	5	HRP
8c4ebff2-8318-4046-98f5-da8f6b1a9e3b	0	0	1	1	HRP	0	0	1	1	HRP
8c5f9574-c622-11e3-bf01-24c6515278c0	0	1	1	2	HRP	0	2	1	3	HRP
8c619cbc-9e91-4716-9711-5236e55d8f46	4	2	6	12	HRP	4	2	6	12	HRP
8c850df7-d48e-4386-b3a5-cac5da865ea5	2	6	0	8	HRP	2	6	0	8	HRP
8ca665f8-fe78-48bf-8c0f-c606d92885d4	16	7	18	41	HRP	12	10	18	40	HRP
8cbd1752-7eea-46d3-8623-09e96dfb1fdf	2	0	1	3	HRP	1	0	1	2	HRP
8cce153d-953d-40c5-976b-60f6a143608c	0	0	0	0	HRP	0	0	0	0	HRP
8ce95cae-6adb-4bac-b072-94e2d9b70017	0	0	0	0	HRP	0	0	0	0	HRP
8cf713ff-256b-4411-a1b4-5bf6f445b747	0	1	3	4	HRP	0	2	3	5	HRP
8cf9b32d-3d6f-4898-8c7a-89511b754021	3	0	3	6	HRP	3	0	3	6	HRP
8d4cb709-c95c-4bdc-844b-c0bfa2a3028e	10	7	18	35	HRP	8	15	18	41	HRP
8d5ffe62-6dd9-4764-b0b7-5e3010eefe6d	15	8	12	35	HRP	7	11	12	30	HRP
8d67c121-37d0-4fc0-a349-2c9452589d65	12	9	9	30	HRP	8	16	9	33	HRP
8d7592e2-c622-11e3-bf01-24c6515278c0	2	2	0	4	HRP	1	3	0	4	HRP
8da641e4-9b12-4163-bd1e-9d5af91e5186	9	4	13	26	HRP	8	11	13	32	HRP
8dd14f0e-8601-4aa1-864c-3c49e768cdd1	20	18	18	56	HRD	13	34	18	65	HRD
8ddcf0d9-312f-4055-8984-55d463face34	0	1	0	1	HRP	0	3	0	3	HRP
8e03e773-5557-4e78-889b-4710c515378f	22	10	25	57	HRD	15	24	25	64	HRD
8e48aa43-6cd1-4aef-83ce-2451b1b86e8e	25	9	13	47	HRP	17	16	13	46	HRP
8e7fe8bb-6b3d-428f-a232-97e6042a0f39	6	2	4	12	HRP	6	8	4	18	HRP
8ea666b7-2b6e-4df8-9a9d-b8265b9749b4	8	8	9	25	HRP	4	16	9	29	HRP
8eb90ea4-c622-11e3-bf01-24c6515278c0	0	0	4	4	HRP	0	1	4	5	HRP
8efb116f-4ecf-4191-8ebf-90a94c1880cf	1	1	3	5	HRP	1	2	3	6	HRP
8f558713-f32b-403b-aedf-c79efeb41c67	11	8	21	40	HRP	6	23	21	50	HRP
8fa0484b-5f95-4ec8-b3de-cea2e8f3c5ca	3	2	3	8	HRP	1	2	3	6	HRP
8fa7549d-d0a6-4216-9763-74b0f21c0fd7	1	1	0	2	HRP	1	1	0	2	HRP
8fa9575b-b2c9-4bd7-8da1-3c2cdf0e39f6	2	3	0	5	HRP	1	4	0	5	HRP
8fb7fcac-6c1d-40c2-9309-b53821cbef30	0	0	0	0	HRP	0	0	0	0	HRP
8fc11cb6-9d79-41c3-bb45-0dadda890e8d	10	4	5	19	HRP	8	19	5	32	HRP
8fc7a4cc-c25d-4372-bf17-2dae795e5596	1	2	2	5	HRP	1	2	2	5	HRP
8fd5e62c-c622-11e3-bf01-24c6515278c0	9	9	5	23	HRP	8	13	5	26	HRP
8ff9b1b6-a498-47fe-a970-ab7cfb64e653	11	9	16	36	HRP	7	19	16	42	HRP
9011cf17-0783-4f9d-b355-4f0fc1a2e78b	10	2	15	27	HRP	6	11	15	32	HRP
9020b6a5-8325-4b0d-84d9-04371c857910	10	13	17	40	HRP	8	28	17	53	HRD
9032b7fe-e38a-4641-a45e-67041668adc4	38	15	24	77	HRD	28	38	24	90	HRD
90611290-e44c-438e-91aa-f3b83dae3b71	6	8	9	23	HRP	4	14	9	27	HRP
906f6f1e-569d-4ce2-9273-1f305782f77f	1	7	9	17	HRP	1	10	9	20	HRP
9078333d-73d3-496a-9fc3-a94353b7e107	6	5	7	18	HRP	4	6	7	17	HRP
90883300-d4b6-45d7-af9a-4e4ce4104500	0	0	0	0	HRP	0	0	0	0	HRP
909f3c5d-89fc-419b-a654-75ac1dbb149f	1	0	1	2	HRP	1	0	1	2	HRP
90ab64be-2229-4a8e-b864-4260b6cb39e9	0	1	1	2	HRP	0	1	1	2	HRP
90b3c237-29a4-48b3-90b3-9f2c0ccb5928	8	3	9	20	HRP	6	5	9	20	HRP
90de4296-0223-4b9f-8abb-6db278bfc932	0	0	0	0	HRP	0	0	0	0	HRP
90fd404b-f734-41ed-a601-0f30e43625fc	4	11	7	22	HRP	3	27	7	37	HRP
91397d9c-3120-407f-8847-74b356943469	0	0	0	0	HRP	0	2	0	2	HRP
914421d2-898e-433e-bb66-b1710eaae2c7	4	2	5	11	HRP	4	5	5	14	HRP
915cbb43-9e00-433d-818f-531011bea57e	0	0	0	0	HRP	0	0	0	0	HRP
917564e4-c622-11e3-bf01-24c6515278c0	2	3	5	10	HRP	1	4	5	10	HRP
91b6fd6b-547a-47e4-8ecb-a6f1826ccfd3	10	9	2	21	HRP	8	16	2	26	HRP
91f458e6-64b7-454d-a542-b0aa23638fd8	15	9	32	56	HRD	11	31	32	74	HRD
92126163-00c3-41f2-9ce6-7aad5f621407	0	1	1	2	HRP	0	1	1	2	HRP
924613ef-8732-4703-a387-136d37b2ba6b	0	0	0	0	HRP	0	0	0	0	HRP
924bcc4a-c982-43bf-8bbb-641dc983d65e	3	4	6	13	HRP	3	5	6	14	HRP
9258860c-a336-4075-996d-2ee0c18b281c	12	7	12	31	HRP	9	11	12	32	HRP
926a04de-ef57-4271-91db-e90de8aa8a1a	30	11	14	55	HRD	24	22	14	60	HRD
929f2216-6ab3-414f-a814-49b69d4b49d9	2	4	5	11	HRP	1	13	5	19	HRP
92dc0e0c-842f-40de-9c39-486b491ea80a	16	6	18	40	HRP	11	14	18	43	HRP
931b24da-5d6d-4c2d-8de9-ef32d6eb8565	20	15	35	70	HRD	20	85	35	140	HRD
9321341c-c622-11e3-bf01-24c6515278c0	6	5	10	21	HRP	4	8	10	22	HRP
935b113e-f5ed-4a07-8e1d-1603daba7f40	35	14	29	78	HRD	22	35	29	86	HRD
93a49462-4bd3-4efa-87a5-69006abba5a0	4	3	9	16	HRP	2	8	9	19	HRP
93b51c61-6eea-4228-a102-840a2e118522	0	0	0	0	HRP	0	0	0	0	HRP
93be2990-bceb-45fd-aca5-3358d96e9d5a	3	3	4	10	HRP	1	4	4	9	HRP
93ff786e-0165-4b02-8d27-806d422e93fc	1	0	2	3	HRP	0	1	2	3	HRP
94108975-b7a0-40ba-ad39-e44cc62e8cc0	8	10	33	51	HRP	4	20	33	57	HRD
941fcb56-e059-403d-aab1-0692a3ecc45e	22	10	21	53	HRP	16	23	21	60	HRD
94244f28-4ba2-4aa6-a0fb-0cd9b94bf9cc	1	0	1	2	HRP	0	0	1	1	HRP
94431626-c622-11e3-bf01-24c6515278c0	10	9	21	40	HRP	9	38	21	68	HRD
94434272-4cbd-4b4d-bd98-44f18526dd69	1	0	0	1	HRP	0	0	0	0	HRP
945e6808-2887-4f32-ac32-8f9e00353bf6	5	4	8	17	HRP	3	4	8	15	HRP
94652d14-2e4d-4f4a-a4f7-8df77df788c0	4	1	7	12	HRP	3	6	7	16	HRP
94b5dc5a-701a-45e3-8f63-8231031a055a	0	0	0	0	HRP	0	0	0	0	HRP
94cf1801-a720-4b2f-aab5-0b76c8ccb242	0	0	0	0	HRP	0	0	0	0	HRP
950486ad-14f8-480a-b079-9cc3cd842090	0	0	2	2	HRP	0	1	2	3	HRP
9536f736-63bc-4099-bd54-740f5910f4a8	4	4	9	17	HRP	4	12	9	25	HRP
955763f0-0735-418f-9ea4-3c980a966002	0	0	0	0	HRP	0	0	0	0	HRP
9563a264-c622-11e3-bf01-24c6515278c0	3	0	4	7	HRP	1	2	4	7	HRP
95730d8b-327a-402c-a8bf-d71370f777a7	9	5	4	18	HRP	6	11	4	21	HRP
958d4d1d-25e2-43f2-a18b-59b2c66f0c05	9	5	4	18	HRP	6	7	4	17	HRP
959efb81-1d56-4659-9b7a-09f2b62483f2	1	1	2	4	HRP	0	2	2	4	HRP
95cc9620-7686-4805-a96c-cf8e659847c3	1	0	4	5	HRP	1	0	4	5	HRP
95e8d38a-122e-494c-a304-bef4275fed7e	7	10	18	35	HRP	4	29	18	51	HRP
95fc38ac-2b36-4c46-abbf-8d2d52ff9626	9	4	14	27	HRP	4	14	14	32	HRP
9623d295-c23d-4f2f-827c-69f767a26f1f	19	12	24	55	HRD	11	19	24	54	HRD
9650640f-154d-4696-aa96-3611c6fcee7b	7	2	4	13	HRP	5	4	4	13	HRP
96517058-18d2-4847-8085-768ca8aa1565	6	4	11	21	HRP	2	10	11	23	HRP
968929b0-6bfb-4a2c-bd4d-570bfcdb8a6a	0	1	0	1	HRP	0	1	0	1	HRP
9689cb33-8ac9-4ee5-800d-3900769988af	0	0	0	0	HRP	0	0	0	0	HRP
96a2896c-1e32-4827-a526-6b7104832f9a	13	13	16	42	HRP	10	23	16	49	HRP
96abdbc8-c622-11e3-bf01-24c6515278c0	7	7	13	27	HRP	6	18	13	37	HRP
96b67289-9c42-402b-8e30-9efb4d512bef	1	0	4	5	HRP	0	2	4	6	HRP
96ba50eb-3c12-41ad-ac7b-d23b2001fe44	13	6	20	39	HRP	9	20	20	49	HRP
96cca60e-17dc-44c3-90f7-1b57b0e08e5f	7	2	6	15	HRP	6	5	6	17	HRP
96dc785c-8417-4813-8d15-c32b22d78b74	19	4	18	41	HRP	10	12	18	40	HRP
96e3db14-2bb1-4f68-aed6-5e794750c96e	3	4	3	10	HRP	1	12	3	16	HRP
96e62134-b8cc-4931-9c99-1193448c7c93	2	3	2	7	HRP	1	4	2	7	HRP
96e99cf0-707e-49f3-9ec6-cb4f90ecf7e4	0	0	0	0	HRP	0	0	0	0	HRP
96ef40c3-8d4c-4fe1-a33a-99f5b205a0bb	3	1	3	7	HRP	2	4	3	9	HRP
96f337d2-cec4-4484-87cd-ab2109d2bf50	15	8	24	47	HRP	10	50	24	84	HRD
97064332-1d4f-4571-93ff-354ffe6d7df9	23	10	19	52	HRP	17	28	19	64	HRD
973d0577-8ca4-44a1-817f-1d3c1bada151	17	8	28	53	HRP	8	24	28	60	HRD
9749a9a5-cb7f-4038-a5f9-5e2d6b97c689	14	7	10	31	HRP	11	16	10	37	HRP
978ae91e-6ebe-4efa-97ff-cfad511ae7b3	1	3	9	13	HRP	0	3	9	12	HRP
97a6f44a-c622-11e3-bf01-24c6515278c0	0	0	0	0	HRP	0	0	0	0	HRP
97c1a300-978d-4df1-9e97-ce2f92b9eff1	0	0	0	0	HRP	0	0	0	0	HRP
97c46ede-b280-4344-8dbb-e860c6472239	9	7	16	32	HRP	6	15	16	37	HRP
97f451e5-a1cc-4f29-8318-0e6ae74efe2f	4	2	5	11	HRP	4	4	5	13	HRP
982b58c4-02b3-4e7d-8af0-4b133d0c7e50	6	8	1	15	HRP	5	16	1	22	HRP
983c14b8-f35b-497b-9fd4-5e5f5f0a7aa7	9	3	9	21	HRP	8	6	9	23	HRP
987528ac-437a-4eb8-a335-4f2076d5c006	54	13	36	103	HRD	46	60	36	142	HRD
987d41ee-6bab-490c-b0f2-bf28c0089de9	8	8	17	33	HRP	6	21	17	44	HRP
9880c3c9-5685-42a7-8fe9-7585ea1a1d37	1	2	1	4	HRP	0	4	1	5	HRP
98bb3025-0637-4106-8621-12df7b5d662f	5	1	8	14	HRP	4	3	8	15	HRP
98d27916-c622-11e3-bf01-24c6515278c0	7	6	10	23	HRP	6	10	10	26	HRP
98e8f23c-5970-4fce-9551-4b11a772fe1b	12	4	20	36	HRP	8	22	20	50	HRP
98f54445-b151-4aeb-b8cf-91d743ba066e	0	0	0	0	HRP	0	0	0	0	HRP
992d9566-b1da-421a-bf36-d23382b115fa	9	5	6	20	HRP	6	10	6	22	HRP
995a1ad2-faca-4a37-a59d-e62455985afb	2	4	4	10	HRP	2	5	4	11	HRP
99696731-c88f-427b-975b-1d90013e63ff	6	2	14	22	HRP	6	5	14	25	HRP
9988eb07-01f6-4f83-8699-bb63e0525f08	25	10	36	71	HRD	15	28	36	79	HRD
99bdc3da-c622-11e3-bf01-24c6515278c0	8	5	8	21	HRP	7	13	8	28	HRP
99e7016a-c3c1-431c-8838-beb78a3cc017	0	0	1	1	HRP	0	1	1	2	HRP
9a015939-8810-4808-9dfa-fb60a1173bc7	0	0	1	1	HRP	0	1	1	2	HRP
9a5bb831-8cb8-4de0-b94b-088cb38def1a	30	18	33	81	HRD	26	83	33	142	HRD
9a90f951-ad96-4883-b97f-ac43395dae5d	1	0	0	1	HRP	0	0	0	0	HRP
9aac83e4-c622-11e3-bf01-24c6515278c0	3	2	6	11	HRP	2	6	6	14	HRP
9ae0744a-9bc1-4cd7-b7cf-c6569ed9e4aa	3	4	1	8	HRP	3	9	1	13	HRP
9ae33a63-6b1a-43bf-9205-463c867bcbc4	23	6	15	44	HRP	16	14	15	45	HRP
9aecfc8f-62ea-4acf-aa00-d1f0fe6c6556	0	1	3	4	HRP	0	9	3	12	HRP
9b3e7a03-cf8c-4da8-bc36-20129d7783ba	6	7	7	20	HRP	4	12	7	23	HRP
9b75735b-705d-4ebf-92a0-fbb190b95285	2	1	2	5	HRP	2	2	2	6	HRP
9ba2c970-c622-11e3-bf01-24c6515278c0	1	1	3	5	HRP	0	1	3	4	HRP
9ba6be6d-2032-444b-ab3c-dbee8023759d	2	3	3	8	HRP	1	4	3	8	HRP
9bb9164e-ea1b-49ab-bbcc-f59cf8c32345	15	10	20	45	HRP	8	20	20	48	HRP
9be1246b-3dc1-4928-8b89-2d5ed0c866e8	2	4	0	6	HRP	2	4	0	6	HRP
9beb4126-0112-4c06-80a3-e5dd1c2b88d5	3	2	15	20	HRP	3	2	15	20	HRP
9c00828e-e9ae-4b9c-959e-34837ee2b230	12	8	14	34	HRP	8	20	14	42	HRP
9c181313-5b4c-41c5-9ad5-a5a86fe609aa	0	0	1	1	HRP	0	0	1	1	HRP
9c27fedd-b1b3-4af0-9e9b-20271854db08	10	13	9	32	HRP	7	22	9	38	HRP
9c399826-087f-44b9-98c0-bd881646b0f4	7	7	14	28	HRP	6	14	14	34	HRP
9c681cd9-25fb-42ac-aa6b-bb962882fa22	4	12	9	25	HRP	4	21	9	34	HRP
9c70688d-6e43-4520-9262-eaae4e4d597d	10	8	10	28	HRP	7	21	10	38	HRP
9c730cfb-3fd6-428a-a0a4-c061ca5db06c	0	0	0	0	HRP	0	0	0	0	HRP
9c7b3ac8-1352-49cd-8a8c-df6b19f6fd64	2	1	1	4	HRP	2	1	1	4	HRP
9c857452-c81d-4b9e-87a8-5b41f4394f7c	9	10	12	31	HRP	7	15	12	34	HRP
9c949c63-aa63-4a84-ac5a-b5260775cee6	0	0	0	0	HRP	0	0	0	0	HRP
9cb80280-c622-11e3-bf01-24c6515278c0	9	6	17	32	HRP	7	21	17	45	HRP
9cdb1905-8b0f-48bd-ba37-11e7ac9646a0	4	3	3	10	HRP	3	6	3	12	HRP
9cfa4e8f-ea4d-433b-8c2c-54f66ecb7e43	2	0	0	2	HRP	2	0	0	2	HRP
9d2671b9-bd30-4e3c-aa74-01e31dd2531e	0	1	1	2	HRP	0	1	1	2	HRP
9d29543e-8601-4fd0-8e76-3df3de465cab	1	0	0	1	HRP	0	0	0	0	HRP
9d3b0b87-5fc5-4d09-9c63-4d5fc4bc46d0	1	0	1	2	HRP	1	1	1	3	HRP
9d691fa3-5c32-4b98-85c4-f6e0fd4c37e0	6	1	9	16	HRP	5	4	9	18	HRP
9db994a0-c622-11e3-bf01-24c6515278c0	2	3	9	14	HRP	0	9	9	18	HRP
9ddf2119-a222-4fa5-a9f3-0bec7eeea36b	58	13	27	98	HRD	45	28	27	100	HRD
9de495d1-55b2-4535-9b0a-a999df35977c	14	8	6	28	HRP	10	10	6	26	HRP
9df57388-7de1-4c90-910e-ef63a246dff1	7	3	10	20	HRP	5	3	10	18	HRP
9dfcbabf-2bc0-43a2-bdde-d0b2aaca3f6b	1	0	0	1	HRP	0	0	0	0	HRP
9e0009d1-c993-4247-9706-88ee84591dec	7	10	24	41	HRP	5	26	24	55	HRD
9e272bea-9193-4c10-a802-f7e18b2937a3	10	6	9	25	HRP	6	18	9	33	HRP
9e5f0a23-e184-4611-b42b-e882dcf23acd	5	2	4	11	HRP	4	4	4	12	HRP
9e6806c4-d331-4025-abee-2f576e3bf182	22	18	27	67	HRD	16	46	27	89	HRD
9e7b51fb-2249-451a-bf23-bb2a3d935928	9	11	27	47	HRP	6	36	27	69	HRD
9e842227-2bc6-4185-bedb-abeb03836b51	0	2	2	4	HRP	0	2	2	4	HRP
9e99b8d9-6f0d-4fe0-9c1e-d286c0714909	1	0	1	2	HRP	1	0	1	2	HRP
9ebac79d-8b38-4469-837e-b834725fe6d5	19	8	21	48	HRP	15	11	21	47	HRP
9ec31146-c622-11e3-bf01-24c6515278c0	2	1	10	13	HRP	1	1	10	12	HRP
9ed8f0b9-d615-44c4-9ec9-e07ecd744922	4	2	5	11	HRP	4	7	5	16	HRP
9f298806-77b6-4c76-bd38-3343e1a3c6f0	0	0	1	1	HRP	0	0	1	1	HRP
9f5e6063-d19e-4f56-b3f9-5c2260d3bfc9	0	0	0	0	HRP	0	0	0	0	HRP
9fb6b7be-0084-48f7-a256-6d170e72e97f	3	9	16	28	HRP	1	13	16	30	HRP
9fb73d89-f7c4-47b2-810b-3ce37cd8a3c9	0	0	0	0	HRP	0	0	0	0	HRP
9fba5db6-c622-11e3-bf01-24c6515278c0	4	4	9	17	HRP	2	8	9	19	HRP
9fc0e0e8-1b0f-400c-b4cf-126193283695	1	0	0	1	HRP	0	0	0	0	HRP
9fc5b5c7-3973-42b4-8710-454de0cb5b50	4	2	10	16	HRP	3	9	10	22	HRP
9ff21093-58d7-4b69-aade-c242a383ea56	3	1	7	11	HRP	2	3	7	12	HRP
9ffcb7fa-424c-4f93-87a7-ce5e9053c613	12	8	15	35	HRP	10	10	15	35	HRP
9ffe694e-b488-489e-bdbe-0800e505eec4	6	4	10	20	HRP	3	9	10	22	HRP
a0583407-712d-46f3-8c4e-4eeaa0149087	13	7	13	33	HRP	12	13	13	38	HRP
a08c196e-4f96-4b16-94b4-aa6a0153ac50	18	6	17	41	HRP	15	25	17	57	HRD
a08ec059-7592-4698-bb45-25a9c3680c23	3	4	0	7	HRP	1	7	0	8	HRP
a0bbb3b1-e774-4c75-9301-ba43fb803f20	10	11	20	41	HRP	3	28	20	51	HRP
a0e317b1-3f3b-4d25-b2d9-fcc2211dfda3	0	1	1	2	HRP	0	1	1	2	HRP
a0eb2611-1ca6-44b7-897e-ce18399eb7bc	0	1	2	3	HRP	0	1	2	3	HRP
a0f94565-9169-49ee-8e6a-21bdc43d9de6	2	1	1	4	HRP	1	5	1	7	HRP
a0fe80e0-e3ac-485b-8a1a-4c80c101b874	21	9	17	47	HRP	17	18	17	52	HRP
a13ee768-1423-4fcc-b663-caaf6694acb3	0	0	0	0	HRP	0	0	0	0	HRP
a1724132-f95c-4622-8987-fe3183b9dce3	2	2	1	5	HRP	2	4	1	7	HRP
a1a75f66-c622-11e3-bf01-24c6515278c0	5	9	16	30	HRP	4	19	16	39	HRP
a1af7c42-47af-435c-bb51-b932a3cd7b91	5	4	4	13	HRP	5	7	4	16	HRP
a1e3dc5b-b81f-4890-870c-ed3b8ac36dec	18	12	22	52	HRP	14	21	22	57	HRD
a1fc7064-abf5-477d-983e-576a784e1d40	15	2	10	27	HRP	6	6	10	22	HRP
a2034620-e4b5-4d4f-ac05-7fc1c098eb40	0	2	3	5	HRP	0	2	3	5	HRP
a2238b5f-0513-487a-9b1b-7bef85ebf336	14	6	16	36	HRP	9	10	16	35	HRP
a284fe9d-9afd-4472-8d70-243ca9be5c2c	18	5	18	41	HRP	16	16	18	50	HRP
a29278af-7ecf-403e-b6a9-623ea7879d05	3	2	4	9	HRP	1	3	4	8	HRP
a2a4021e-1273-4c18-907c-d20454ab898c	0	0	1	1	HRP	0	0	1	1	HRP
a2a67c8a-c622-11e3-bf01-24c6515278c0	4	1	7	12	HRP	1	2	7	10	HRP
a2e67393-50d7-4bcc-9bbd-c695086a936a	29	11	18	58	HRD	24	24	18	66	HRD
a2ee5dde-4342-4e78-88c5-3c9a8e10cbf5	3	2	4	9	HRP	1	4	4	9	HRP
a2f02ff7-8433-4cb5-9324-34f13edeaca1	8	2	13	23	HRP	7	9	13	29	HRP
a2f143d6-ba07-4ff0-960d-b29c3c716665	4	4	15	23	HRP	3	14	15	32	HRP
a3135834-3af0-4e98-bc6f-ad8ddf33db80	25	18	23	66	HRD	22	70	23	115	HRD
a315b798-f037-48d5-91ed-e733e3bbd6ee	5	7	8	20	HRP	0	14	8	22	HRP
a319188c-6b80-4228-8f2b-8f423c0fcf97	0	1	0	1	HRP	0	1	0	1	HRP
a31b6123-c1b7-4cd0-86d8-b2e640cce9da	2	4	5	11	HRP	1	7	5	13	HRP
a3210fd0-344c-468e-8ff2-2d0869a2fb75	7	5	6	18	HRP	7	8	6	21	HRP
a330a96e-9897-4605-b5f1-5b5ef45cd365	14	9	8	31	HRP	8	13	8	29	HRP
a335b03d-41ac-4d41-a2a9-3134b5b0a0a7	0	2	2	4	HRP	0	2	2	4	HRP
a37a825c-d74e-46cc-92ef-b65016857b4a	12	8	15	35	HRP	5	16	15	36	HRP
a3914a6c-c622-11e3-bf01-24c6515278c0	17	13	18	48	HRP	12	25	18	55	HRD
a3deafcb-b54f-4b7e-89ac-c92c16fb919f	3	2	6	11	HRP	0	10	6	16	HRP
a3edc9cc-f54a-4459-a5d0-097879c811e5	7	3	9	19	HRP	5	6	9	20	HRP
a441697c-4ca0-4eab-9b01-b9cb50223ce2	0	0	0	0	HRP	0	0	0	0	HRP
a46f1e20-9e97-4dcc-a5ed-532aad9f3236	0	0	0	0	HRP	0	0	0	0	HRP
a47c2012-c13d-48ac-88b6-e09bfd50122b	5	3	3	11	HRP	4	5	3	12	HRP
a492a32b-bf2f-4f8c-b06e-794a4baa2fe7	8	6	15	29	HRP	7	8	15	30	HRP
a4beedc3-0e96-4e1c-90b4-3674dfc01786	1	2	4	7	HRP	0	3	4	7	HRP
a4c838df-6ac4-455a-8096-8ec680064374	5	1	5	11	HRP	2	3	5	10	HRP
a4ca18dc-c622-11e3-bf01-24c6515278c0	2	6	6	14	HRP	2	9	6	17	HRP
a4f8305f-4409-4776-b34d-4878d18c8693	0	1	1	2	HRP	0	2	1	3	HRP
a5346247-3f30-470a-b4ab-732180786291	9	4	14	27	HRP	6	12	14	32	HRP
a54aac0e-4108-49cf-bf50-687031c7cda6	1	2	1	4	HRP	0	2	1	3	HRP
a56cd282-f6c5-4373-b3d8-676562894598	0	1	2	3	HRP	0	1	2	3	HRP
a592e80a-3b1a-46aa-be30-bcd87d6bca6f	0	0	0	0	HRP	0	0	0	0	HRP
a5d5c238-0447-47fa-9a81-3b823cbdcea6	6	0	7	13	HRP	3	6	7	16	HRP
a6045753-60bb-4e65-bc89-1ef0b47aab35	7	1	5	13	HRP	3	5	5	13	HRP
a612b654-c622-11e3-bf01-24c6515278c0	19	9	18	46	HRP	16	19	18	53	HRD
a64000df-16e5-4b88-865f-5c680adf60eb	7	5	10	22	HRP	5	11	10	26	HRP
a65bcd07-c47d-4bda-a2bf-21f68cef2f3b	1	1	1	3	HRP	1	5	1	7	HRP
a67f4531-99ef-43df-82f5-f6abc4b11826	5	12	23	40	HRP	5	24	23	52	HRP
a68389d4-431f-4582-b4df-e8ad200aa3be	0	0	0	0	HRP	0	0	0	0	HRP
a6957d15-453c-4f3b-ab8c-c38054dfe548	7	8	3	18	HRP	5	12	3	20	HRP
a6c14ebc-81a2-44f7-af87-2b7ec85e5696	15	3	11	29	HRP	14	7	11	32	HRP
a6d8467e-88e3-4ea5-8583-61c5ab9747ae	6	3	2	11	HRP	5	9	2	16	HRP
a6e24c2a-26b9-409c-bbcd-a8fcdd1e437c	8	5	9	22	HRP	4	6	9	19	HRP
a6ebe0c0-8aab-4b9f-8328-4b795895a77d	6	6	15	27	HRP	5	9	15	29	HRP
a7314730-c622-11e3-bf01-24c6515278c0	5	5	14	24	HRP	5	8	14	27	HRP
a742a46d-2594-4efe-a701-4a2737ffae81	0	0	0	0	HRP	0	0	0	0	HRP
a762dd44-a8ac-4269-8163-bbf6d0f8d4b3	19	9	24	52	HRP	11	28	24	63	HRD
a78544d7-65c6-4778-af62-ceec24c14056	7	8	11	26	HRP	3	16	11	30	HRP
a7a56d67-1bd7-4d69-9237-34c2d261261b	17	13	10	40	HRP	10	16	10	36	HRP
a7e1deb7-2e3d-4e36-90c7-9cae34cdcfb3	0	0	0	0	HRP	0	0	0	0	HRP
a7fb0931-28df-46f4-bc0f-2011fc91f0e1	0	0	0	0	HRP	0	0	0	0	HRP
a8041e86-071e-46cd-8fb5-7ecdc1ab0553	2	3	9	14	HRP	1	6	9	16	HRP
a83e247a-8f65-4be4-9c6e-a72c4abffae8	0	0	0	0	HRP	0	0	0	0	HRP
a846f5e8-c622-11e3-bf01-24c6515278c0	10	6	12	28	HRP	8	11	12	31	HRP
a84915de-6562-4836-86f9-f2a05598296e	8	8	12	28	HRP	3	12	12	27	HRP
a85cf239-ff51-46e7-9b88-4c2cb49c66b9	40	15	35	90	HRD	37	59	35	131	HRD
a876398c-5b1d-444f-a360-5fe2db697480	41	18	29	88	HRD	36	42	29	107	HRD
a89a2341-263d-4e7f-87fa-18d9692d6b2b	0	0	1	1	HRP	0	0	1	1	HRP
a8f86b64-914c-4d89-897b-33bcdd1759f7	2	1	1	4	HRP	1	2	1	4	HRP
a92023de-5c97-4bf2-aa3c-0e768d7c5ece	5	6	6	17	HRP	4	13	6	23	HRP
a94d63fa-c622-11e3-bf01-24c6515278c0	6	6	9	21	HRP	5	9	9	23	HRP
a96eddfc-3afb-4bf8-a440-c91778113fbd	11	3	16	30	HRP	7	16	16	39	HRP
a971ac23-0664-405d-9f5c-9ca892af003e	1	1	0	2	HRP	1	3	0	4	HRP
a9a240f3-d237-4bb8-b968-e4a3cc7c2633	1	2	0	3	HRP	0	2	0	2	HRP
a9c29edd-2ef1-46ef-93c6-796cf0332a2b	0	0	0	0	HRP	0	0	0	0	HRP
a9d055c6-6c53-4e85-8270-34883a1342a9	0	0	0	0	HRP	0	0	0	0	HRP
a9dbd55c-5dcc-48db-8785-6baef3fdd7db	1	1	3	5	HRP	1	1	3	5	HRP
a9ec7d9e-b179-4782-a589-43c7d1642be9	1	0	0	1	HRP	1	2	0	3	HRP
aa018d90-5250-4313-9f7c-a3f196765e07	1	0	1	2	HRP	1	0	1	2	HRP
aa06ae46-2336-4666-a3af-fc790daf8da4	8	2	15	25	HRP	6	15	15	36	HRP
aa20b9ab-dba9-4002-ad45-cafa2f85cef7	0	0	0	0	HRP	0	0	0	0	HRP
aa215f18-ae1f-4f0e-89dd-ac59ee8c8c44	1	1	3	5	HRP	0	2	3	5	HRP
aa2654f4-94f9-487a-b415-85df69261161	0	0	0	0	HRP	0	0	0	0	HRP
aa4a868a-df23-4eef-a618-e945aa2ce98a	10	7	17	34	HRP	8	19	17	44	HRP
aa4bf69c-a1a6-48dc-96fc-3fe7d2680517	1	0	1	2	HRP	1	0	1	2	HRP
aa58c09a-7799-4675-8310-d270224b163e	3	1	6	10	HRP	1	5	6	12	HRP
aa5907cb-3be3-4e23-982d-719417baeb37	2	0	2	4	HRP	2	2	2	6	HRP
aa847c3d-d3a7-46aa-a81b-db5099a458fb	2	3	1	6	HRP	1	3	1	5	HRP
aabddb20-c622-11e3-bf01-24c6515278c0	19	14	18	51	HRP	16	43	18	77	HRD
aacaba97-ecde-440b-aae0-0e9c608c4b24	10	10	18	38	HRP	9	20	18	47	HRP
aad8c8d6-d828-4aac-9cfb-cee893e36850	0	2	5	7	HRP	0	2	5	7	HRP
ab318624-db9d-41d8-b7b8-34712434f28f	0	0	0	0	HRP	0	0	0	0	HRP
ab8a55ed-ff47-4cad-ad91-52b9dc25aca7	3	0	4	7	HRP	2	3	4	9	HRP
ab923db7-54e8-4a50-b7fd-c2b4b300041e	4	1	7	12	HRP	1	5	7	13	HRP
abbbe65c-c622-11e3-bf01-24c6515278c0	9	6	13	28	HRP	5	9	13	27	HRP
abc94013-71f5-4ac6-88a4-01b4ef9f9d2f	13	4	14	31	HRP	10	12	14	36	HRP
abd2d959-d5ed-4eb3-9759-67eb1aa23325	3	9	6	18	HRP	3	12	6	21	HRP
abe290ed-67c8-42bb-84f7-0d32a5f8f3db	13	12	22	47	HRP	11	33	22	66	HRD
abedd46c-47b8-4242-adb6-12835400cb3f	3	4	3	10	HRP	2	5	3	10	HRP
ac02c38e-5fca-4995-b0cc-39b6189976a3	11	3	12	26	HRP	11	16	12	39	HRP
ac1bd179-8285-468c-ab9f-7f91151ca0f2	1	0	1	2	HRP	1	0	1	2	HRP
ac23a8d2-ac42-4031-9dd4-9b56baeb246e	0	0	0	0	HRP	0	0	0	0	HRP
ac2c8928-33a2-4aa0-8bc1-cdfa1ca0b56a	4	2	4	10	HRP	4	2	4	10	HRP
aca4d810-9540-4ce3-8ceb-72d396c9b704	1	2	3	6	HRP	1	4	3	8	HRP
acb5e263-111b-43d8-9bd1-adb9a54e0fc0	0	1	1	2	HRP	0	1	1	2	HRP
acb9750e-7e17-4cef-bee1-5d710f9bf3a7	5	3	2	10	HRP	5	14	2	21	HRP
acc629cb-ad03-4cec-9b21-922e4932ef3e	4	2	7	13	HRP	4	5	7	16	HRP
accfc45b-eae0-4991-a488-e217cdb46655	2	5	5	12	HRP	2	6	5	13	HRP
acd510de-b732-4a1a-8b72-6d22e763540b	11	12	25	48	HRP	9	35	25	69	HRD
ad007b59-46f6-48b9-958a-2b9d28cca3b7	6	6	6	18	HRP	5	13	6	24	HRP
ad0700e2-048a-4856-a77a-bc0b6f25f0e2	1	1	1	3	HRP	1	1	1	3	HRP
ad41f1f3-e38e-4418-9c16-52bca5719f39	9	8	12	29	HRP	6	17	12	35	HRP
ad4aa4dc-bea4-4f4a-8b1b-8f361112f84f	7	5	12	24	HRP	4	15	12	31	HRP
ad874249-9964-4e48-aa3f-7e828ea28f3f	1	0	1	2	HRP	1	2	1	4	HRP
ad92f17f-11e6-49bd-9835-6b2f47053485	1	0	2	3	HRP	1	0	2	3	HRP
ad9455e9-7147-489e-9b1f-3540c457c260	8	8	11	27	HRP	5	16	11	32	HRP
add0b0f6-b4a8-4b73-b634-c3600dc567d5	4	1	6	11	HRP	4	1	6	11	HRP
adfbba82-c622-11e3-bf01-24c6515278c0	3	1	5	9	HRP	3	4	5	12	HRP
ae464652-2f8c-4d94-8b08-cd8f1d29256e	1	0	1	2	HRP	1	0	1	2	HRP
ae82fead-2671-4335-a342-67bb69935ad9	11	9	14	34	HRP	10	20	14	44	HRP
aed4363b-19b8-4cb5-aa34-a442410d0796	2	4	8	14	HRP	0	7	8	15	HRP
aeeb01b4-790e-4929-bd59-6aad837603b1	0	0	0	0	HRP	0	0	0	0	HRP
af2cbdb6-c622-11e3-bf01-24c6515278c0	2	4	4	10	HRP	2	5	4	11	HRP
af96db5a-684f-41d1-a910-5a5193393d9c	9	4	8	21	HRP	5	7	8	20	HRP
af9cfac8-7fbe-49cb-aeca-8d68aea57994	15	7	23	45	HRP	11	19	23	53	HRD
afd1f2e0-343c-416d-8e8f-2177f312c2f0	0	0	0	0	HRP	0	0	0	0	HRP
afee5b10-3dff-4e50-9575-bc9fe20c5dea	17	6	13	36	HRP	15	17	13	45	HRP
aff5793b-3197-4d1d-bf0a-9b0ded5f2937	0	0	0	0	HRP	0	0	0	0	HRP
affa4ef4-02ec-40f1-b6a2-739f8bf2afa9	6	2	4	12	HRP	4	8	4	16	HRP
b02b4bba-6e66-44fb-a48f-38c309aaaac5	8	7	7	22	HRP	6	11	7	24	HRP
b04624d2-d8f8-4b51-be1b-72c73d8055f9	8	4	8	20	HRP	5	18	8	31	HRP
b061cb06-e927-4f24-82bb-9e651f7ae0e3	1	2	2	5	HRP	0	2	2	4	HRP
b070af2a-c622-11e3-bf01-24c6515278c0	16	7	23	46	HRP	11	21	23	55	HRD
b07bad52-d44c-4b27-900a-960985bfadec	3	2	7	12	HRP	3	3	7	13	HRP
b0a83df8-dd2c-4c1b-b238-9081d2c22258	0	1	1	2	HRP	0	1	1	2	HRP
b0c61486-b061-4b6b-ac02-130a3ea0b080	0	0	0	0	HRP	0	0	0	0	HRP
b0d1fde4-928f-4f4c-bff6-33b885582bb5	0	1	1	2	HRP	0	1	1	2	HRP
b0f3087b-6f9c-47e9-b487-6726af1cb90b	1	4	0	5	HRP	1	4	0	5	HRP
b16780b0-75ba-4304-87e0-33f1e321b622	3	12	13	28	HRP	1	20	13	34	HRP
b1753e9c-29d0-4955-89d2-949cdabd1211	0	0	0	0	HRP	0	0	0	0	HRP
b19ec4cd-2876-4a2b-bcb9-b3c8db54fc15	0	0	0	0	HRP	0	0	0	0	HRP
b1d2457d-3267-46ba-9fdf-663985e60538	0	0	0	0	HRP	0	0	0	0	HRP
b1e62d8e-24d2-4118-8cd0-3142acebdd5b	2	1	1	4	HRP	2	2	1	5	HRP
b1f19de6-c622-11e3-bf01-24c6515278c0	9	3	7	19	HRP	7	8	7	22	HRP
b1f2442f-a973-47b4-9891-f028f0d44adc	6	2	4	12	HRP	5	5	4	14	HRP
b2190e26-1809-4aba-9f45-07c2edb3b4a4	1	3	4	8	HRP	1	4	4	9	HRP
b243adb4-b3e7-4e0e-bc0d-625aa8dbb1be	23	6	19	48	HRP	21	38	19	78	HRD
b24feafa-f2e9-4498-8471-a9e42c80cc9f	1	0	0	1	HRP	0	0	0	0	HRP
b27b569a-2c79-4453-8a2d-41fd0b4dd28d	2	1	5	8	HRP	2	2	5	9	HRP
b27d75ba-5989-4200-bfe9-f1b7d7cf8008	33	17	25	75	HRD	29	45	25	99	HRD
b28f7607-f162-425f-b44d-64e9633c8824	0	0	0	0	HRP	0	0	0	0	HRP
b2afbcba-d67d-43f1-be3b-05f3a5836ec0	0	2	4	6	HRP	0	2	4	6	HRP
b2d17671-d2e1-4c97-8b01-a976d5abe1d6	11	6	12	29	HRP	10	15	12	37	HRP
b2d9aaff-5a48-48f0-bf55-bfd4ddaeccaf	9	7	8	24	HRP	7	14	8	29	HRP
b2ec0fd0-fbcf-4abc-ad80-4ae444e30b55	2	0	2	4	HRP	1	0	2	3	HRP
b30dfb8b-8288-4e5a-afc2-3d5bd7bfa26c	1	2	3	6	HRP	0	3	3	6	HRP
b32449c0-c622-11e3-bf01-24c6515278c0	6	17	16	39	HRP	6	44	16	66	HRD
b330c50b-c45f-413d-918f-33275d0d8f91	2	3	1	6	HRP	1	3	1	5	HRP
b33978c6-a855-4f9d-a0b0-d79453b9de41	0	1	0	1	HRP	0	2	0	2	HRP
b33b7c8f-0b0d-4009-88a7-48e9d9cae6cb	3	3	1	7	HRP	1	3	1	5	HRP
b35d9a68-29f4-49ab-b83e-b5151679e3af	27	14	30	71	HRD	26	51	30	107	HRD
b37d6283-6f95-4975-a794-f3d5c4bbc7b3	10	8	9	27	HRP	3	10	9	22	HRP
b38d0777-4901-48b8-9cdc-33b7f13a424f	22	13	24	59	HRD	14	36	24	74	HRD
b3b3a27c-ee9a-42af-a6d1-9af5970a98b9	3	2	7	12	HRP	1	4	7	12	HRP
b3befa40-8f44-4eb6-ada0-ec395f460656	14	3	20	37	HRP	9	12	20	41	HRP
b3f1d232-4392-4258-9256-d38ff4b59f94	4	5	5	14	HRP	4	13	5	22	HRP
b41c63e8-bb85-4f83-9bc6-e611fd9ef075	2	1	3	6	HRP	1	5	3	9	HRP
b421b9ca-c622-11e3-bf01-24c6515278c0	5	11	16	32	HRP	4	19	16	39	HRP
b42d183c-bc9c-4652-9e56-10c54c5ee96e	0	6	10	16	HRP	0	12	10	22	HRP
b47aa163-eec9-4225-940b-4373e78152e2	6	3	4	13	HRP	5	4	4	13	HRP
b4860b5f-0a80-4fb2-81e1-4bafeb525b1c	0	0	0	0	HRP	0	0	0	0	HRP
b499032c-6cb8-4646-a95b-10af2a21a289	0	0	0	0	HRP	0	0	0	0	HRP
b49d5310-3cc5-4386-9444-cf0d61b52376	14	8	12	34	HRP	10	28	12	50	HRP
b4aea804-fc6e-4d58-906f-f3a932ca9dc5	2	1	2	5	HRP	2	5	2	9	HRP
b4e5626b-44fe-4cdb-a7d5-42028e0dbc4d	3	2	2	7	HRP	0	2	2	4	HRP
b4f515ce-5bee-4e40-a66a-01f41e92181e	16	11	13	40	HRP	10	25	13	48	HRP
b51fa117-2c0a-4e1d-8ec4-9f039073a486	0	3	4	7	HRP	0	3	4	7	HRP
b537bc07-9998-49f4-bbbe-5b617152bfd9	5	1	6	12	HRP	4	4	6	14	HRP
b53dcb4d-f894-47b8-8a4e-17c7998d8120	10	4	20	34	HRP	6	25	20	51	HRP
b54b9433-ec10-4cb5-a860-4555da64917b	8	7	15	30	HRP	6	18	15	39	HRP
b55751c4-c622-11e3-bf01-24c6515278c0	4	1	6	11	HRP	3	3	6	12	HRP
b5cabba2-30a4-458e-897c-00ec3fefa6d2	5	2	9	16	HRP	4	8	9	21	HRP
b5cc4a6d-93a9-497c-a7bb-a5db82edc176	0	0	0	0	HRP	0	0	0	0	HRP
b5dd0bc9-6c1c-4272-b920-744de37d0aee	5	5	3	13	HRP	4	11	3	18	HRP
b5f90cb8-7304-48fb-a1d3-ff459c7d79d1	7	1	9	17	HRP	5	3	9	17	HRP
b60392fb-43d9-4c9c-b91b-ded40492e61c	4	0	5	9	HRP	4	2	5	11	HRP
b61f7f76-f365-4071-a28d-bf354d5a670d	0	1	0	1	HRP	0	1	0	1	HRP
b6365bdb-e6d5-4615-95b3-db12a0c2f3d9	1	2	1	4	HRP	0	2	1	3	HRP
b64173fc-abac-4695-902b-f0acf9444e9f	0	3	4	7	HRP	0	4	4	8	HRP
b67208c4-c622-11e3-bf01-24c6515278c0	5	2	6	13	HRP	4	6	6	16	HRP
b68c5ec2-0875-4d77-b4b7-738d2b2f313c	0	0	0	0	HRP	0	0	0	0	HRP
b68f18e1-0117-420c-9405-e8d3a1e8caff	3	5	7	15	HRP	2	6	7	15	HRP
b6b6e1d3-c592-4836-bdad-d53af2dbcc9a	8	10	16	34	HRP	5	15	16	36	HRP
b7008a98-5aa0-4cc9-9bee-af2a422266db	17	6	15	38	HRP	13	21	15	49	HRP
b710b214-5666-4054-97ef-3b9ac2bd90ac	13	4	9	26	HRP	11	14	9	34	HRP
b73523d7-f5a5-4140-8537-4df4d1ecf465	10	9	24	43	HRP	3	26	24	53	HRD
b752b444-f033-4be4-9d24-e5e80b4181af	46	18	32	96	HRD	36	63	32	131	HRD
b757a040-3c9e-45e7-a045-9cd08db11d62	34	12	33	79	HRD	29	37	33	99	HRD
b75b2663-dcc6-411c-bfcc-574aa33cf388	14	17	15	46	HRP	9	26	15	50	HRP
b77084ab-8148-49e0-b3f9-90f7d9ea1862	8	2	12	22	HRP	7	14	12	33	HRP
b7722577-f200-4dec-97f6-4fab3a9ba52d	0	2	3	5	HRP	0	3	3	6	HRP
b77543e4-c622-11e3-bf01-24c6515278c0	5	15	8	28	HRP	5	26	8	39	HRP
b7a7d93b-38a7-4fc3-a433-3bb0a8cb7c42	10	6	13	29	HRP	5	12	13	30	HRP
b7f11036-7ac4-41bc-a9a4-64162725fdfc	9	6	17	32	HRP	9	18	17	44	HRP
b7f2e85a-3c6a-48b7-8a4f-2dec1d85359d	0	1	1	2	HRP	0	1	1	2	HRP
b7fbd99c-dea0-4448-a430-7f94c611e702	2	2	11	15	HRP	0	8	11	19	HRP
b8068cbb-4523-4ac9-ab17-edd4eb0e2975	0	0	0	0	HRP	0	0	0	0	HRP
b80ca528-2c5f-400c-8df3-9c47869a64c2	3	3	6	12	HRP	1	6	6	13	HRP
b8151614-b08f-49a3-ab6f-2e780f765a17	7	3	2	12	HRP	5	7	2	14	HRP
b8270565-9e02-4d46-9534-08206bfd027a	6	0	6	12	HRP	6	4	6	16	HRP
b86655a4-c622-11e3-bf01-24c6515278c0	3	7	8	18	HRP	2	10	8	20	HRP
b86678f3-c9cf-4ba4-8248-3efb2a7c4884	4	7	12	23	HRP	2	13	12	27	HRP
b86e88e7-0d5f-4b32-a35f-dc97251ab990	4	3	8	15	HRP	3	4	8	15	HRP
b88f014e-bc0f-4775-8228-39e0b471c3b0	17	7	21	45	HRP	10	23	21	54	HRD
b8cd6882-be27-4742-bc63-3227d31bf704	0	0	0	0	HRP	0	0	0	0	HRP
b8f3137e-5e92-4a56-90d4-884a4ed2ef9c	14	8	20	42	HRP	11	22	20	53	HRD
b9098b7c-eab0-4ef5-b968-8d3024bf32f7	3	1	6	10	HRP	1	8	6	15	HRP
b97941dd-9844-4db2-9e25-42c725f47d70	8	6	12	26	HRP	4	14	12	30	HRP
b994762c-c622-11e3-bf01-24c6515278c0	8	12	13	33	HRP	6	17	13	36	HRP
b9bcba3a-c9be-4305-b5f4-c861282921e0	15	3	14	32	HRP	11	9	14	34	HRP
b9d1a64e-d445-4174-a5b4-76dd6ea69419	5	3	4	12	HRP	3	8	4	15	HRP
b9d2e29e-8546-4310-aeea-e029f17c0516	1	1	3	5	HRP	1	2	3	6	HRP
b9dbc78e-44ce-427c-bbeb-de8d097bde2c	2	2	6	10	HRP	1	3	6	10	HRP
b9f03936-1de5-4330-8b0f-6d0ab533876e	1	2	6	9	HRP	1	3	6	10	HRP
ba096d4f-5a6c-4c31-ae03-e7483cf58c38	11	5	10	26	HRP	8	7	10	25	HRP
ba5667da-7688-4931-bdb7-d65f391caf60	0	0	0	0	HRP	0	0	0	0	HRP
ba67c02a-180b-43f3-b53c-2b77d84fbe3c	0	1	2	3	HRP	0	1	2	3	HRP
ba686386-8113-4885-b20f-6ad09a295604	0	0	0	0	HRP	0	0	0	0	HRP
ba940092-c622-11e3-bf01-24c6515278c0	19	14	14	47	HRP	13	19	14	46	HRP
ba94c29b-b76e-4d67-bf5a-ce6bc45d85f8	2	4	4	10	HRP	1	8	4	13	HRP
baa02e74-9cae-4996-858e-17d9f52d924b	0	1	4	5	HRP	0	3	4	7	HRP
bb02202f-d140-4bec-95ce-5c2b117a2167	2	1	2	5	HRP	2	8	2	12	HRP
bb45c6f5-49cb-418d-85bb-3ded165e2d07	0	0	0	0	HRP	0	0	0	0	HRP
bb567851-d4ff-4a93-8576-04a37aea68af	1	0	1	2	HRP	1	0	1	2	HRP
bb5bedd3-d8fc-4739-8e6b-9e37223f8be2	8	5	5	18	HRP	4	14	5	23	HRP
bb6150f7-23e4-40f2-b466-6b6edd19c502	5	1	10	16	HRP	4	3	10	17	HRP
bb659e7c-0b97-41b5-ac10-a66bb1f6f283	5	4	3	12	HRP	2	7	3	12	HRP
bb65d670-0411-4fc5-a6cb-019caec1ab36	15	9	21	45	HRP	11	16	21	48	HRP
bb66787e-e0b2-45b6-b452-98a6c32132e7	0	0	0	0	HRP	0	0	0	0	HRP
bb8176a7-ea7c-42d7-a85a-cec1ca386f2e	5	3	3	11	HRP	3	5	3	11	HRP
bb91765e-4c55-4e7d-93e8-77face8c91f4	0	0	0	0	HRP	0	0	0	0	HRP
bba106ce-c622-11e3-bf01-24c6515278c0	6	4	12	22	HRP	5	7	12	24	HRP
bbb2cf2f-8f32-43d4-846c-d1020e6329ec	3	3	10	16	HRP	1	11	10	22	HRP
bbbc531a-dd41-40b7-ae59-e35508aea0c7	4	1	3	8	HRP	3	3	3	9	HRP
bbdd7393-024b-4073-b5bc-ef7a68c15b8a	29	23	25	77	HRD	20	50	25	95	HRD
bbe59385-5f83-43f6-a485-517c860bef6f	1	9	18	28	HRP	0	16	18	34	HRP
bbff7954-95ec-455c-b0bc-92f67a09ee77	10	6	12	28	HRP	6	9	12	27	HRP
bc0dee07-de20-44d6-be65-05af7e63ac96	22	1	20	43	HRP	22	17	20	59	HRD
bc1d5327-2e76-4e0e-b749-72a559469d0d	16	23	31	70	HRD	12	46	31	89	HRD
bc395326-1656-4ef2-bb19-0cb29194b91c	0	0	0	0	HRP	0	0	0	0	HRP
bc5160ae-d629-46c4-b068-7075876b9103	0	0	1	1	HRP	0	0	1	1	HRP
bc69c97c-65c1-4e1c-a241-d17d3130e024	0	0	0	0	HRP	0	0	0	0	HRP
bc9b66f5-fcb8-4545-ab2d-438bb810edc0	36	20	24	80	HRD	26	44	24	94	HRD
bc9f105f-6d99-44ac-9871-67defd5e85cd	5	6	2	13	HRP	4	9	2	15	HRP
bcc74a5e-c622-11e3-bf01-24c6515278c0	4	4	4	12	HRP	1	6	4	11	HRP
bcc819eb-f4d8-4ddc-9fdc-a6307fb6741b	3	1	2	6	HRP	3	1	2	6	HRP
bcd52bcb-6e35-4220-9775-96dabff926b4	0	0	0	0	HRP	0	0	0	0	HRP
bce88385-4a1b-4a8c-920c-060f6a2675d4	20	7	20	47	HRP	12	16	20	48	HRP
bcef0b6c-6584-4090-9d28-ef784a7e5fbb	6	10	16	32	HRP	5	15	16	36	HRP
bcefbf6a-80ff-4825-9d3a-492e2dceb35d	1	3	8	12	HRP	1	17	8	26	HRP
bcf54c96-2b62-4e24-926f-d77576250dd1	0	0	3	3	HRP	0	1	3	4	HRP
bcf76f1a-7109-422d-94c9-5e8364895fa0	9	9	38	56	HRD	9	58	38	105	HRD
bcf858fd-cc3b-4fde-ab10-eb96216f4366	0	2	2	4	HRP	0	2	2	4	HRP
bd1ce02b-bfaf-4cde-aaac-06097a12e248	0	2	4	6	HRP	0	4	4	8	HRP
bd2cc59d-f5ce-46ed-beb0-4c80b24cbe71	0	0	0	0	HRP	0	0	0	0	HRP
bd2ec47b-a120-4b3b-b10d-aee09805ab33	2	1	2	5	HRP	0	2	2	4	HRP
bd2f8133-3e71-4c5e-998f-0c1a9fdfb75f	22	6	20	48	HRP	19	12	20	51	HRP
bd3028c7-1fde-401d-a6b2-5f8e61eb4aa1	3	4	3	10	HRP	3	7	3	13	HRP
bd3e88b3-b37c-4641-85fa-d8125ba324ca	29	13	17	59	HRD	26	27	17	70	HRD
bd403458-5154-488b-931a-a7e737a6bf8c	3	1	4	8	HRP	1	3	4	8	HRP
bd6bd940-ef06-433a-80d9-dca5683e9cd2	5	3	2	10	HRP	3	6	2	11	HRP
bdbcffb0-c7da-4e7d-8002-9feffe48533c	3	4	1	8	HRP	3	5	1	9	HRP
bdc039d6-4817-4e6f-b8c6-a40b1e8e1a06	0	0	0	0	HRP	0	0	0	0	HRP
bdeeb1a6-c622-11e3-bf01-24c6515278c0	3	1	3	7	HRP	1	1	3	5	HRP
bea0e802-96d3-46e2-8030-17019a71e0bb	0	0	0	0	HRP	0	0	0	0	HRP
beafb7c6-ef39-478e-aa47-0f1ad39f95a3	7	3	3	13	HRP	4	8	3	15	HRP
bef21282-c622-11e3-bf01-24c6515278c0	13	15	19	47	HRP	7	21	19	47	HRP
bef23192-57cd-4301-b7a7-5e82ca62482d	0	0	1	1	HRP	0	0	1	1	HRP
bf24366f-fd91-4d84-8b3d-eed80064250d	1	2	0	3	HRP	0	2	0	2	HRP
bf7462a2-394f-4838-bcb6-4d0126fa48b1	10	11	25	46	HRP	7	27	25	59	HRD
bf91afc4-aa2b-4365-80c5-b98c9d118e10	0	0	2	2	HRP	0	0	2	2	HRP
bff518fb-6da7-4dfc-ae4c-bd3f641028e2	25	12	29	66	HRD	21	71	29	121	HRD
c00d925a-ca4d-4561-a8f2-d4542f218086	0	0	0	0	HRP	0	2	0	2	HRP
c00de7a0-0b09-4e07-988c-ef2a7f8e932a	3	0	2	5	HRP	2	0	2	4	HRP
c016d025-3c92-41c5-b846-493b1fcce79e	8	3	10	21	HRP	6	8	10	24	HRP
c021b61c-c622-11e3-bf01-24c6515278c0	12	7	20	39	HRP	8	27	20	55	HRD
c0523251-3ac2-4292-bb00-9ae9ea9009f6	6	3	10	19	HRP	4	6	10	20	HRP
c05adc19-2e01-4712-a35a-69eee4d40998	13	4	19	36	HRP	10	12	19	41	HRP
c065761d-f775-457f-bda0-4c7c257a701e	11	13	17	41	HRP	10	32	17	59	HRD
c0812962-a345-48b7-aec0-01336c2d1eed	2	2	5	9	HRP	1	5	5	11	HRP
c082dc34-457e-40ec-8258-e11e8ed362c2	0	1	3	4	HRP	0	1	3	4	HRP
c08f65a0-bf4c-462e-9d07-ad56b3adcac8	4	4	2	10	HRP	3	7	2	12	HRP
c121de15-78f7-4698-91bf-fd0485c466c2	1	0	1	2	HRP	1	0	1	2	HRP
c13d7ee5-2bf0-43e4-9cd3-9326ed9355cf	1	2	0	3	HRP	1	2	0	3	HRP
c13fb736-614c-4d5f-83bf-2d7586f4fb53	15	11	7	33	HRP	13	25	7	45	HRP
c14407ad-670e-4d1e-9417-2b76f4810fff	1	0	1	2	HRP	0	0	1	1	HRP
c14b2c74-447b-4526-a6e9-415d2728c7ca	3	3	2	8	HRP	1	4	2	7	HRP
c158ac2a-c622-11e3-bf01-24c6515278c0	0	0	0	0	HRP	0	0	0	0	HRP
c15a51cc-4fdc-4343-a410-13ddc238dac8	6	3	9	18	HRP	3	6	9	18	HRP
c19a1388-95e6-4708-a24c-3738f1908071	1	0	2	3	HRP	0	1	2	3	HRP
c1abb741-4fcd-4161-b057-c7efd619cc99	2	1	3	6	HRP	0	2	3	5	HRP
c1b44966-0f72-4c4f-8783-ab3ffe7f17b2	22	9	16	47	HRP	17	22	16	55	HRD
c1d9ed06-7498-4c6c-a0de-dbf28e868109	9	6	6	21	HRP	8	17	6	31	HRP
c20cb5c8-a6d0-4150-b72b-3f7e8909d72b	1	2	1	4	HRP	0	2	1	3	HRP
c2124bb2-30e1-4093-9a8a-3a188a6dc0a9	13	11	11	35	HRP	9	24	11	44	HRP
c21a5d55-9790-429f-a4e6-420293c07b53	6	2	3	11	HRP	2	6	3	11	HRP
c271b7d2-c622-11e3-bf01-24c6515278c0	5	5	10	20	HRP	3	8	10	21	HRP
c27290e4-6835-448a-abdc-df8ddd5f4630	4	3	4	11	HRP	3	14	4	21	HRP
c285c2fa-24b4-47a1-874d-86e74b002b05	2	2	1	5	HRP	1	6	1	8	HRP
c298ec82-8305-4c89-898f-268308f782b2	3	2	4	9	HRP	3	4	4	11	HRP
c29f6ed6-880d-4f03-977e-1087738e5e60	1	0	0	1	HRP	0	0	0	0	HRP
c2aafb9c-230a-43df-9a43-b34aa145a7bd	1	2	1	4	HRP	1	3	1	5	HRP
c2ec7f57-8510-4bbf-a2e9-dbd9ce8dcad1	19	16	21	56	HRD	12	46	21	79	HRD
c307688c-b1fa-47f6-a9e2-1ea41f7645b6	0	0	0	0	HRP	0	0	0	0	HRP
c36213e4-c057-46f5-ada5-f1f921855bb4	1	0	2	3	HRP	0	1	2	3	HRP
c3679262-63d7-463e-9501-6ab3f177aee8	6	0	5	11	HRP	4	1	5	10	HRP
c3cb64b3-842b-4b42-8c42-020a0206eb06	7	3	6	16	HRP	7	11	6	24	HRP
c437535b-2acc-4236-beae-94e2c1336830	17	10	37	64	HRD	10	36	37	83	HRD
c459dba5-b27c-46f0-b5b8-c62d597a0542	0	0	1	1	HRP	0	0	1	1	HRP
c488a170-c622-11e3-bf01-24c6515278c0	8	1	9	18	HRP	8	7	9	24	HRP
c48d7f4a-e98a-4077-a749-eb9f56f05b84	25	6	24	55	HRD	20	22	24	66	HRD
c4c776f8-ee3f-4cce-beb9-8dcf262cdcdf	1	0	1	2	HRP	1	0	1	2	HRP
c4e048de-1d43-4fbd-8289-9279b16c8a3a	0	0	0	0	HRP	0	0	0	0	HRP
c504d5a9-29b0-4b7e-ac7b-5e543449a0f4	0	0	0	0	HRP	0	0	0	0	HRP
c556f81b-8a6c-4bbb-876f-2e2ce570c185	2	5	15	22	HRP	2	13	15	30	HRP
c56505cb-e150-408d-9df6-3af4e608c376	1	1	2	4	HRP	1	1	2	4	HRP
c569b867-dadd-4591-af17-7e9b74699561	1	3	2	6	HRP	0	4	2	6	HRP
c59188a8-c6bb-433c-97fe-69f79a126d03	0	0	0	0	HRP	0	0	0	0	HRP
c5ad7238-c622-11e3-bf01-24c6515278c0	6	12	15	33	HRP	4	19	15	38	HRP
c5bc0826-8037-4fe6-ad4e-b1b675e771fb	1	0	1	2	HRP	1	0	1	2	HRP
c612570a-881d-421f-98b9-0e4563133744	30	10	24	64	HRD	26	31	24	81	HRD
c61ded54-f80e-4da8-b1d8-e22551c96118	1	0	2	3	HRP	0	1	2	3	HRP
c6224ab0-74f5-4f0a-9fe0-c083f806c853	0	0	0	0	HRP	0	0	0	0	HRP
c642b9cc-bdb1-4796-9692-8be92398be17	3	5	5	13	HRP	2	6	5	13	HRP
c66926a8-474d-482c-bfb7-043029c8b737	7	8	9	24	HRP	7	12	9	28	HRP
c66c92d5-df65-46e6-861d-d8a98808e6a3	1	1	2	4	HRP	1	3	2	6	HRP
c67409b2-ac25-42a0-8543-4636ef132fe4	5	4	10	19	HRP	4	9	10	23	HRP
c6888be2-4517-41e4-a801-9c915f24e737	2	3	2	7	HRP	1	3	2	6	HRP
c691d6b3-8e70-4951-8551-2ee4e4d0d10b	21	7	20	48	HRP	14	20	20	54	HRD
c6a28615-1b92-4085-956e-eeedb2573c03	3	4	1	8	HRP	3	13	1	17	HRP
c6bb32f0-c622-11e3-bf01-24c6515278c0	5	2	6	13	HRP	4	3	6	13	HRP
c6d6f49e-6e95-4e41-8388-71f6fe017d80	1	0	0	1	HRP	0	0	0	0	HRP
c73f3f82-3091-46dd-b667-e96a1d8c501c	0	0	0	0	HRP	0	1	0	1	HRP
c741fb12-8160-43a7-bc70-2c545ea0031d	6	7	10	23	HRP	4	12	10	26	HRP
c75cc75a-7496-420f-b526-ea63c77e9839	12	3	11	26	HRP	10	12	11	33	HRP
c766274a-3c1e-443f-9ed4-c0e2b9c904d1	1	0	0	1	HRP	0	0	0	0	HRP
c767254e-b289-4904-a80f-050cf01ff8ba	48	22	32	102	HRD	44	81	32	157	HRD
c76f7fcc-2748-4b6d-805e-d21652dd5e3a	20	7	23	50	HRP	15	19	23	57	HRD
c79ce3d3-4758-4f52-9da1-38f994c99f4e	0	1	1	2	HRP	0	3	1	4	HRP
c7d798b8-c622-11e3-bf01-24c6515278c0	4	0	7	11	HRP	4	1	7	12	HRP
c8381701-31cb-465a-bdf2-1b8132be7a14	0	0	0	0	HRP	0	0	0	0	HRP
c8e961b4-e324-40a2-89f6-736ec3845bc9	0	1	1	2	HRP	0	2	1	3	HRP
c8f61136-0bea-4fb4-bb63-699af7f22146	0	0	0	0	HRP	0	0	0	0	HRP
c8f64a71-e545-4eb6-9da3-2d43ae0c2627	1	3	4	8	HRP	0	3	4	7	HRP
c906a13e-c622-11e3-bf01-24c6515278c0	0	0	9	9	HRP	0	5	9	14	HRP
c955387a-16e5-447c-8e69-e4c04a9861d5	1	0	0	1	HRP	0	0	0	0	HRP
c95a2b1b-726c-4608-9fff-d57b6f1aa75a	3	4	6	13	HRP	2	7	6	15	HRP
c971ffa7-ce37-4138-b028-598a30478e25	9	3	7	19	HRP	6	14	7	27	HRP
c9959f68-c385-4c1f-9188-8203844d288e	20	16	19	55	HRD	14	33	19	66	HRD
c9ad6b1c-baa0-45a7-b7c4-733728505b8a	4	2	5	11	HRP	3	4	5	12	HRP
c9ca979d-b3ad-4ff0-92d0-140105413d28	0	0	0	0	HRP	0	0	0	0	HRP
c9e7c629-7b57-4ede-b315-0cea8c97c48e	9	5	14	28	HRP	6	10	14	30	HRP
c9e7cff0-aec2-4ff2-8091-7cbea2bf5991	12	15	14	41	HRP	7	22	14	43	HRP
c9f87f0d-4967-4be2-8b92-a20f1980ea22	0	0	0	0	HRP	0	0	0	0	HRP
c9f91ded-3b04-4cd1-8ea6-bbc635a8a4f0	27	14	14	55	HRD	24	23	14	61	HRD
ca004926-f3ac-4824-8ed5-d84e62efdfae	24	13	32	69	HRD	18	54	32	104	HRD
ca137611-533a-4d20-a85d-8e4c3a1eab2d	3	3	3	9	HRP	3	5	3	11	HRP
ca284012-bd06-47a3-8a9d-c6b185d87d85	15	8	12	35	HRP	7	10	12	29	HRP
ca2b9fe2-97e0-4d4f-afd7-a5acf638800f	0	0	0	0	HRP	0	1	0	1	HRP
ca49fdb1-d55a-427c-9819-90980dcd956f	1	0	1	2	HRP	1	0	1	2	HRP
ca5ded1c-c622-11e3-bf01-24c6515278c0	5	7	8	20	HRP	3	9	8	20	HRP
ca8fa9f5-3190-440d-9879-22e33d05ca6c	5	1	5	11	HRP	3	3	5	11	HRP
caf2e99d-8f1f-4043-b567-c3fe28dc33ac	2	2	0	4	HRP	2	10	0	12	HRP
cafe9603-a804-48fb-9217-e2d1c3c346c5	12	11	18	41	HRP	9	25	18	52	HRP
cb381d49-4546-400c-af02-f877083caa0a	8	5	13	26	HRP	6	14	13	33	HRP
cb4608a7-6aec-4cba-b20f-489e214c9dbd	3	4	10	17	HRP	1	8	10	19	HRP
cb56e4c2-2fff-4f09-be34-fbdaa3794b35	4	6	7	17	HRP	2	6	7	15	HRP
cb573c96-f6d4-4897-8919-9827f623b6a7	4	3	5	12	HRP	2	3	5	10	HRP
cb5e1546-cda6-4991-911c-f3dd9f1a475a	11	5	15	31	HRP	9	25	15	49	HRP
cb74d12c-eed1-4b14-8f93-d70e625eb65e	0	1	0	1	HRP	0	1	0	1	HRP
cb753e6f-5ea3-4b58-9db3-7a62d15c8b2e	17	11	21	49	HRP	11	24	21	56	HRD
cb783f8b-d092-4104-b809-3f90b19df7df	11	2	4	17	HRP	8	4	4	16	HRP
cb86fbb6-c622-11e3-bf01-24c6515278c0	2	1	8	11	HRP	0	3	8	11	HRP
cb89cea8-f78e-4024-97c2-8f24debee1bc	0	0	0	0	HRP	0	0	0	0	HRP
cba4de91-cce7-4edc-8450-d0a52c959586	3	2	3	8	HRP	1	2	3	6	HRP
cbb788dd-964b-4cfd-80e1-979c7b5b3c52	3	2	2	7	HRP	1	3	2	6	HRP
cc19a480-9c66-4ee8-a0c0-921acac02689	23	2	18	43	HRP	18	19	18	55	HRD
cc39b534-5ba1-4ea0-956b-676f6732beec	0	0	0	0	HRP	0	0	0	0	HRP
cc4f9175-a8c8-424a-99d7-8bd11cae0e52	9	10	13	32	HRP	5	12	13	30	HRP
cc69fe94-0ecf-45ad-a03f-8fb7198e8657	1	3	4	8	HRP	1	3	4	8	HRP
cc6ab103-f07c-4b80-8c8e-cddc8a4da02e	0	1	1	2	HRP	0	1	1	2	HRP
cc792058-c622-11e3-bf01-24c6515278c0	4	3	9	16	HRP	3	10	9	22	HRP
cc7af465-22ed-485d-a78c-282b840bf7c9	5	2	7	14	HRP	5	10	7	22	HRP
cc7bba1d-8990-4557-a565-9cff1085f023	0	0	0	0	HRP	0	0	0	0	HRP
cd0aeed5-93a1-4287-8a88-fe6b7b5e3983	11	5	14	30	HRP	10	17	14	41	HRP
cd0c3b1f-c73a-4991-8724-4e74381900cb	2	3	0	5	HRP	1	6	0	7	HRP
cd29af7e-d670-4d8e-83e2-da6e52abda71	2	0	2	4	HRP	2	2	2	6	HRP
cd2a045b-fbde-49c6-8be6-c0e3ecee246f	2	0	3	5	HRP	2	0	3	5	HRP
cd3d7559-b583-4474-81df-4bf9232de3c2	1	5	6	12	HRP	1	17	6	24	HRP
cd9efdef-a7fb-49e5-9515-63606ae8bbfc	6	8	12	26	HRP	6	11	12	29	HRP
cda1a403-16b6-487c-a82a-c377d1d0f89d	5	6	12	23	HRP	3	9	12	24	HRP
cdbbd701-9c05-4f9e-923d-06039dd8a04d	13	10	11	34	HRP	11	17	11	39	HRP
cdc2c513-590f-444b-9347-32ba365313a7	0	0	0	0	HRP	0	0	0	0	HRP
cdc672cc-35df-4f10-88f1-d3e40dabf601	3	2	7	12	HRP	3	3	7	13	HRP
cdcc04fc-c622-11e3-bf01-24c6515278c0	4	6	8	18	HRP	3	12	8	23	HRP
cdf045a6-ab6a-4dc5-b0b0-d72fbb26b0bb	0	0	2	2	HRP	0	2	2	4	HRP
cdf313c8-59f9-41c6-9bd2-f47cb4287da5	0	0	0	0	HRP	0	0	0	0	HRP
ce6154e9-3f3a-442f-a608-35e1bab66927	0	0	0	0	HRP	0	0	0	0	HRP
ce799e7b-30e7-44a5-a185-3e50d5e059ef	39	9	24	72	HRD	30	27	24	81	HRD
ce85ccf3-6621-4976-b187-2f28d45dd4d9	13	14	15	42	HRP	10	19	15	44	HRP
cef1fb1c-18fa-453a-b87f-295d3b0bc12b	0	0	0	0	HRP	0	0	0	0	HRP
cf072bfe-3191-4a71-9e0b-decaa28365e1	11	5	13	29	HRP	7	8	13	28	HRP
cf2d34c4-c622-11e3-bf01-24c6515278c0	15	17	23	55	HRD	12	34	23	69	HRD
cf5deb22-f7eb-409d-a0e4-882716199c39	0	0	0	0	HRP	0	0	0	0	HRP
cf6c7066-6611-43ec-aef1-295a976cce5b	11	21	20	52	HRP	8	50	20	78	HRD
cf777ef1-765f-4828-b789-f5aa6722eb35	4	5	10	19	HRP	1	12	10	23	HRP
cfe0bf13-2ff4-4164-9b6a-cd3615bf3ddc	5	5	17	27	HRP	4	18	17	39	HRP
d00625b4-6e0e-4d96-8e4c-8f1ddcc7aded	0	0	0	0	HRP	0	0	0	0	HRP
d0161ca7-3c33-4fe5-80df-0cc4b3c4e8ee	1	1	1	3	HRP	1	4	1	6	HRP
d01710f9-efc8-4b5f-9e53-300b30f9219f	1	0	2	3	HRP	1	0	2	3	HRP
d02597f8-3ac7-4165-a65f-0e134e5d215b	1	3	5	9	HRP	0	7	5	12	HRP
d0469256-c622-11e3-bf01-24c6515278c0	6	5	8	19	HRP	3	8	8	19	HRP
d053f88f-09e6-472e-a691-bb293c461399	7	6	7	20	HRP	5	12	7	24	HRP
d056645f-4dd3-49f3-b0a4-2293e2b4d82c	3	3	7	13	HRP	3	14	7	24	HRP
d05ea63c-86a3-463a-a790-2edaa74b4da7	9	4	11	24	HRP	7	11	11	29	HRP
d0a0d845-32e2-4590-b909-29bd27b92900	5	2	6	13	HRP	4	3	6	13	HRP
d0a33fd2-085c-488b-b843-2ca97c85a5cb	0	1	1	2	HRP	0	1	1	2	HRP
d0e033bc-8e97-4322-b3b1-8626f1e2449b	3	6	8	17	HRP	2	7	8	17	HRP
d0f4dd92-a63b-4766-8889-5327fca1bd91	4	5	1	10	HRP	2	7	1	10	HRP
d1132127-1250-43af-9c16-425798a3d1a7	5	2	1	8	HRP	2	3	1	6	HRP
d113ce88-04ab-4675-b363-92f80c28de34	1	0	0	1	HRP	0	0	0	0	HRP
d12cfd8b-682d-41df-acf8-ee7f68a6241c	19	6	9	34	HRP	16	10	9	35	HRP
d17c2123-d262-43f4-9d06-3547f991cde7	4	2	7	13	HRP	2	2	7	11	HRP
d1804679-e728-4597-ac69-49554c087b9e	8	6	16	30	HRP	4	15	16	35	HRP
d182b67c-c622-11e3-bf01-24c6515278c0	11	8	14	33	HRP	6	15	14	35	HRP
d1842491-29ff-4801-8c8a-4d619f749dd1	16	7	24	47	HRP	11	23	24	58	HRD
d1875ee6-6677-4117-a7a8-930ab5cde775	6	5	3	14	HRP	5	5	3	13	HRP
d18c6e64-9598-488a-8ab3-3652072f9277	14	6	18	38	HRP	10	29	18	57	HRD
d1be624b-eb76-4ce3-a6ba-ffc5b23953d3	0	0	0	0	HRP	0	0	0	0	HRP
d1cebf4a-4127-47ee-85cb-465fca2ac445	2	2	1	5	HRP	2	2	1	5	HRP
d1d2932b-f1c4-4080-9b75-dcf1ab0ab217	0	0	0	0	HRP	0	0	0	0	HRP
d252a54e-0377-4b3e-8228-26108ea704fa	2	2	1	5	HRP	1	2	1	4	HRP
d252f328-4583-4e97-9a71-bb2885f06f73	8	7	17	32	HRP	6	16	17	39	HRP
d25a4c65-9cb4-4611-909e-e68f93408d84	5	2	6	13	HRP	1	3	6	10	HRP
d2620dab-4319-499a-b8f1-9575aaf8f4f3	4	3	6	13	HRP	2	8	6	16	HRP
d277e679-9fdd-44cd-9f2c-f9927e44d721	1	1	0	2	HRP	1	2	0	3	HRP
d2ab2555-7288-47a4-a80c-bf62d65b67b8	21	15	20	56	HRD	16	25	20	61	HRD
d2ab7fd4-d1c7-48ae-ba9a-78c5d811465e	2	1	2	5	HRP	0	1	2	3	HRP
d2b7bb0a-c622-11e3-bf01-24c6515278c0	1	1	4	6	HRP	1	4	4	9	HRP
d2e4dc23-992d-4e44-add4-2972718083cb	22	17	25	64	HRD	17	45	25	87	HRD
d31cce9d-1b38-44fd-9378-0d128e12a011	4	3	2	9	HRP	2	5	2	9	HRP
d32f41fb-0744-4a62-81f6-0260c4920049	4	5	2	11	HRP	4	9	2	15	HRP
d333b55b-8bac-4a99-9d23-3cc0c25057bf	9	3	8	20	HRP	9	5	8	22	HRP
d3709eea-ca2a-49ac-b79c-871a5473d450	3	3	6	12	HRP	1	3	6	10	HRP
d392ded3-afc8-4c79-b278-40245f18f2f8	15	6	25	46	HRP	11	15	25	51	HRP
d3ad5b5a-c622-11e3-bf01-24c6515278c0	6	4	10	20	HRP	3	5	10	18	HRP
d3aff5d3-23c0-43ae-9c01-8ddd776b530b	5	3	7	15	HRP	3	13	7	23	HRP
d3b72600-a888-4ef6-ac5d-661c105405dd	0	1	2	3	HRP	0	1	2	3	HRP
d3d65db3-36f9-41c7-8e5e-1683ce94dfcb	3	15	18	36	HRP	2	23	18	43	HRP
d3daf373-1485-455e-a0a1-8e33d215d623	10	9	10	29	HRP	3	15	10	28	HRP
d404ac28-da11-4746-9c3b-cf0b1888f67b	11	4	8	23	HRP	6	16	8	30	HRP
d414e076-dcb6-4edf-adef-0abdc57354ea	1	1	3	5	HRP	1	1	3	5	HRP
d429c27a-5963-42fe-b3a0-7252c20669d8	2	3	3	8	HRP	1	4	3	8	HRP
d432e99a-67fb-4609-b90f-99438eee7cae	3	3	7	13	HRP	2	8	7	17	HRP
d452293a-6148-4fcf-9fbc-446815016751	12	6	17	35	HRP	9	12	17	38	HRP
d4615ca0-b5c7-4a5c-8593-bd50034a78ae	3	1	6	10	HRP	2	5	6	13	HRP
d4907a1b-8b06-47c5-8bca-c781d9cddaf8	7	6	16	29	HRP	5	13	16	34	HRP
d4b80307-abbd-48bb-b52c-6dcd409699a2	9	7	8	24	HRP	6	10	8	24	HRP
d4bf6034-aeae-48a6-907b-10e2cc904015	23	17	33	73	HRD	19	71	33	123	HRD
d4c6061b-5019-4564-806d-4e75910a4690	0	0	2	2	HRP	0	0	2	2	HRP
d4c9e5c6-c622-11e3-bf01-24c6515278c0	3	4	3	10	HRP	2	5	3	10	HRP
d4cf11be-3bd7-403b-9722-91d8e8761e4d	9	6	8	23	HRP	5	14	8	27	HRP
d4ea36e2-1323-4441-8c63-40ce269608f4	2	1	3	6	HRP	1	1	3	5	HRP
d4ecbf52-f6a9-4394-9d3b-8eb8eee1b17b	0	0	0	0	HRP	0	0	0	0	HRP
d515c7d2-2314-46bf-9736-ff3f3d2ab599	1	2	2	5	HRP	1	2	2	5	HRP
d5372745-95cf-4572-a6e7-e7f5b796911a	50	21	34	105	HRD	44	55	34	133	HRD
d53c2680-89ac-4f87-a7ba-f4c669546b76	6	5	15	26	HRP	3	11	15	29	HRP
d5423a93-0a72-43cf-a7ae-9011f47553c7	2	4	3	9	HRP	1	4	3	8	HRP
d5443922-fea5-4ff0-bd6e-8ce04e1951d8	10	0	9	19	HRP	8	6	9	23	HRP
d54ca81c-1bcc-41ea-b17a-9f7249ebe9c1	9	10	17	36	HRP	5	23	17	45	HRP
d5796835-d6cd-427e-a398-5fbef88b0648	3	2	4	9	HRP	2	5	4	11	HRP
d5c87d16-172f-4790-8867-949dcaa534d4	1	2	4	7	HRP	0	4	4	8	HRP
d5f92ce6-796f-480d-bf98-e1080a279207	4	1	4	9	HRP	3	6	4	13	HRP
d609ce92-9edd-4286-bd5f-b93304cae9a2	3	1	2	6	HRP	2	1	2	5	HRP
d60f54f5-b154-42c4-99fb-cea4e7a33dc7	7	3	6	16	HRP	6	9	6	21	HRP
d60f880a-c622-11e3-bf01-24c6515278c0	7	4	11	22	HRP	5	14	11	30	HRP
d648c804-4eaf-4252-8b6f-13378158a07d	2	0	1	3	HRP	2	0	1	3	HRP
d6738c83-7b52-4224-846a-67bd085aaab8	1	4	4	9	HRP	0	4	4	8	HRP
d67cad13-e849-48b0-926c-10b6046ba0b9	9	3	27	39	HRP	6	27	27	60	HRD
d692ecd0-2433-426b-9af2-a30c44a80f7c	1	4	4	9	HRP	1	4	4	9	HRP
d6ccfd6f-2ea9-499d-a25d-4ba9d4a9258e	1	0	2	3	HRP	0	1	2	3	HRP
d6ee68e5-ceb3-4a63-b3bd-e64fe5398102	1	2	0	3	HRP	1	2	0	3	HRP
d6faafa5-7279-4dc3-be71-45af5c855b34	2	0	1	3	HRP	1	0	1	2	HRP
d707940e-0f9d-4da3-9380-90a422e44efd	22	4	21	47	HRP	16	32	21	69	HRD
d709d214-02ee-46c1-a73a-e7074cb2623e	2	2	1	5	HRP	1	5	1	7	HRP
d72a7338-c144-4c62-a70e-2177a3b4b77e	2	0	1	3	HRP	0	0	1	1	HRP
d733cf1a-4c42-4def-b6cb-5ef2c6a27fcd	2	3	12	17	HRP	1	6	12	19	HRP
d74be531-b0fd-42c3-954e-4a4f7eef922a	0	0	0	0	HRP	0	0	0	0	HRP
d7578910-c622-11e3-bf01-24c6515278c0	2	3	1	6	HRP	1	4	1	6	HRP
d7f8e1f3-a9a7-4929-92df-1283bac815d2	7	1	4	12	HRP	6	7	4	17	HRP
d8415cf6-8e4d-4c54-811e-199da14237f1	0	0	1	1	HRP	0	1	1	2	HRP
d876d576-c622-11e3-bf01-24c6515278c0	2	0	4	6	HRP	1	1	4	6	HRP
d88296ac-bb0d-47ab-9051-6c358f0af780	0	0	0	0	HRP	0	0	0	0	HRP
d884d070-6077-4155-9978-76aca7ba1e76	0	0	0	0	HRP	0	0	0	0	HRP
d8995dfa-a780-4fe6-b3f8-fb464f51a1cf	3	2	4	9	HRP	2	4	4	10	HRP
d8c2b4b2-e12b-43d2-bafc-87b29f027797	39	19	31	89	HRD	35	69	31	135	HRD
d8c6d4b8-f279-4edc-aaa3-a1cc266aec4d	22	4	19	45	HRP	22	31	19	72	HRD
d8d5585d-32cd-4ac4-b410-a4122a17a558	17	13	20	50	HRP	13	34	20	67	HRD
d8de6de6-4cfe-4239-9ebd-3437aa65efb2	9	6	13	28	HRP	6	12	13	31	HRP
d8e2af63-afe0-4f15-88b4-78118cf68160	0	0	1	1	HRP	0	0	1	1	HRP
d8f0becd-fda8-41f4-a424-e082f9eae22c	15	12	23	50	HRP	13	46	23	82	HRD
d8fbb398-d1da-4444-984a-22c8523625da	30	25	28	83	HRD	27	56	28	111	HRD
d91e1a92-837d-44d6-92d8-419f435effe0	0	0	0	0	HRP	0	3	0	3	HRP
d91f487e-0895-44ef-aeb1-a62bd576f8b0	16	3	13	32	HRP	11	9	13	33	HRP
d926a39f-d057-4e78-8907-b74f52157d99	0	1	2	3	HRP	0	2	2	4	HRP
d9338d73-1d5e-4808-91f2-b5a09f7342de	2	2	4	8	HRP	1	4	4	9	HRP
d9690a27-bb02-498e-b15c-ee76e31d16ee	5	3	2	10	HRP	4	3	2	9	HRP
d991f23a-dc1b-427a-b798-bd4187d3aa02	0	1	0	1	HRP	0	1	0	1	HRP
d9c5493e-f969-4c04-a646-9a3134011021	2	3	6	11	HRP	0	3	6	9	HRP
d9cd7f95-07d3-4b87-be83-87340b08d249	5	7	12	24	HRP	2	26	12	40	HRP
d9e66fc5-9018-4568-b388-c5eb756f7823	20	17	20	57	HRD	17	36	20	73	HRD
da10f77f-4414-4125-b359-de596421cca6	0	0	0	0	HRP	0	0	0	0	HRP
da1ed4b9-f428-48aa-834d-1d9673999044	14	5	18	37	HRP	14	15	18	47	HRP
da43386c-47f8-4e03-b6ca-8b94e13792e7	27	17	27	71	HRD	24	76	27	127	HRD
da5b9926-c622-11e3-bf01-24c6515278c0	41	11	20	72	HRD	33	36	20	89	HRD
da910f22-126e-41dc-be6b-47c8f69ad106	12	6	10	28	HRP	7	22	10	39	HRP
dabb5a94-9706-4429-8db0-c328e2004340	15	3	23	41	HRP	10	30	23	63	HRD
dabdd983-a819-410e-bfb8-5c66a66cf5ab	2	2	2	6	HRP	1	2	2	5	HRP
dacd4cc2-fc2b-4fbd-adf6-c8a46ae69c91	0	0	0	0	HRP	0	0	0	0	HRP
db198301-6c69-4d56-88d1-c650406423dd	5	3	3	11	HRP	4	3	3	10	HRP
db2a1df8-487d-4dad-a347-5c5ed539d5ad	10	4	9	23	HRP	9	9	9	27	HRP
db37739d-af50-4e63-9147-1a7d25630ac6	2	2	0	4	HRP	2	3	0	5	HRP
db4592fb-13c2-4d61-9dc3-a5d43def8d4b	0	1	0	1	HRP	0	1	0	1	HRP
db45d81f-695c-4f99-beea-6dbec1ff47fc	15	14	21	50	HRP	8	33	21	62	HRD
db4d1d04-1189-4c0e-99a7-904667af07b5	0	1	4	5	HRP	0	1	4	5	HRP
db650eff-4e2c-4ce3-9124-7697b6e03359	0	0	0	0	HRP	0	0	0	0	HRP
db98d6d5-94a5-4559-8f29-49eb74f83ce3	0	0	0	0	HRP	0	0	0	0	HRP
db9ce6c6-529c-4da6-92c4-f4f3fc3fe109	1	2	1	4	HRP	1	2	1	4	HRP
dbacc1ad-c88a-4bcf-a45f-e9c83c762164	0	0	0	0	HRP	0	0	0	0	HRP
dbae3c4e-6d66-483a-a611-7285067bf85c	2	3	5	10	HRP	1	4	5	10	HRP
dbbd54db-4470-4df6-b5be-3e175c7133b0	27	26	22	75	HRD	21	42	22	85	HRD
dbd834cb-b14f-4380-9741-f96551268447	0	2	3	5	HRP	0	4	3	7	HRP
dbfa4e8a-c622-11e3-bf01-24c6515278c0	9	6	14	29	HRP	7	11	14	32	HRP
dbfdb5c6-f52e-48f3-87e7-fb922df9e7a9	2	1	2	5	HRP	1	4	2	7	HRP
dc107863-2c7d-4b19-8afb-666c7798f0da	5	1	3	9	HRP	2	1	3	6	HRP
dc4ba4bc-6333-4fe9-8805-e058cc9e6e18	17	6	16	39	HRP	11	11	16	38	HRP
dc4bc4c4-2cc1-4a2e-a9f2-613088af17bf	2	3	0	5	HRP	2	4	0	6	HRP
dc505248-ed04-4f77-a7c6-3fefbc5df27b	1	2	0	3	HRP	0	3	0	3	HRP
dc537fcf-d910-4c4b-8af9-e7da429f2633	12	15	25	52	HRP	11	43	25	79	HRD
dc57c2e7-4c5b-4e2b-93c6-f032fcebc2fa	1	0	0	1	HRP	0	0	0	0	HRP
dc7faf84-4438-447b-abcf-a3af87043654	1	2	5	8	HRP	0	9	5	14	HRP
dc85552c-2488-48d9-9da1-67a380945b85	4	4	4	12	HRP	3	12	4	19	HRP
dc856038-f5f7-4dfc-a0a4-3e3a6b8d160f	5	1	9	15	HRP	1	1	9	11	HRP
dcc938da-3e45-4c2f-ae0f-47817be04518	3	4	2	9	HRP	3	6	2	11	HRP
dccddb92-bb26-4dc9-a935-2320d089a54a	0	0	0	0	HRP	0	0	0	0	HRP
dce54d09-9827-4fe2-abe1-c5b7d528ba7f	22	15	24	61	HRD	18	49	24	91	HRD
dcf45005-7e6d-4c26-9994-f973da7e814f	2	1	4	7	HRP	1	3	4	8	HRP
dcf98acc-736b-4af6-bdca-a320a413165a	6	7	0	13	HRP	4	18	0	22	HRP
dd09c7aa-744a-413d-839f-e75e1825f9f9	1	3	3	7	HRP	0	4	3	7	HRP
dd2e7b3c-c622-11e3-bf01-24c6515278c0	4	5	6	15	HRP	2	6	6	14	HRP
dd4fdb6a-8067-4b64-ab74-bbb0fec34ca9	1	1	3	5	HRP	1	2	3	6	HRP
dd5ed858-0623-4387-b1bf-109175c32ef4	3	1	1	5	HRP	3	2	1	6	HRP
dd67dec6-35dd-4efe-b913-ed4884855365	4	2	17	23	HRP	1	6	17	24	HRP
dd7d623b-b9af-4147-9aa6-e09793691f10	2	0	1	3	HRP	2	0	1	3	HRP
dd8f3e1c-6ed6-41c2-957d-6f679a3cb3ca	3	4	6	13	HRP	2	9	6	17	HRP
dd9d2e9e-02dc-40fc-842b-c5b9707fca56	4	2	7	13	HRP	4	3	7	14	HRP
ddb6c68e-0c90-4bde-a011-523600ce8b29	0	0	0	0	HRP	0	0	0	0	HRP
ddc422e4-87e2-4fc0-b56b-ddc2d6a92f58	0	0	0	0	HRP	0	1	0	1	HRP
ddc7377d-82c3-480a-be3c-3d1da52c77d4	6	2	11	19	HRP	5	11	11	27	HRP
dddea2e4-b8c3-4157-9d92-6de472e8375a	1	0	1	2	HRP	1	0	1	2	HRP
de4c3f91-d164-47df-9971-feba840d247c	3	3	6	12	HRP	0	4	6	10	HRP
de4d6f9f-d64a-41b9-a928-64e79b9f7d5f	2	0	0	2	HRP	1	0	0	1	HRP
de4f520c-c622-11e3-bf01-24c6515278c0	5	3	7	15	HRP	1	3	7	11	HRP
de4faf55-1bcf-427f-b019-829bb4b64ff1	3	2	0	5	HRP	2	4	0	6	HRP
de55876b-5d7d-46e7-bf3e-35db7a155300	0	0	0	0	HRP	0	0	0	0	HRP
de581588-be15-4bf4-95d1-aa5478b53ab6	10	5	14	29	HRP	6	16	14	36	HRP
de614a3e-1c0d-49c7-a2f1-28bc58e6e5c7	10	17	23	50	HRP	9	45	23	77	HRD
de8ef60b-4dbe-4aa8-adef-6f58cdfada29	16	8	23	47	HRP	13	16	23	52	HRP
de92d076-24b7-46eb-8df6-56094d264f3b	0	0	0	0	HRP	0	0	0	0	HRP
de99a4de-e916-4572-ac9e-73e341827229	0	0	0	0	HRP	0	0	0	0	HRP
deb0de92-a46b-4e71-814c-2f6c5e97dbcd	3	2	2	7	HRP	3	3	2	8	HRP
deb9fbb6-656b-41ce-8299-554efc2379bd	9	3	10	22	HRP	5	12	10	27	HRP
dec775c5-7d9a-4dc5-b399-dc4b7ba49d73	22	8	26	56	HRD	18	32	26	76	HRD
decfb419-63b3-47b0-9dfc-baae180566a0	0	3	3	6	HRP	0	4	3	7	HRP
ded2689b-8e37-480c-b37c-acc538e54ddf	6	8	2	16	HRP	6	17	2	25	HRP
ded8b673-53df-4038-a375-7cd0fd2a1b9f	11	3	4	18	HRP	8	17	4	29	HRP
def5526a-774a-4704-bb24-10c4e713649a	0	0	1	1	HRP	0	0	1	1	HRP
df291849-4c35-44e1-b013-8f6b7ee36113	11	16	23	50	HRP	9	34	23	66	HRD
df2d41c4-7e79-4a46-aa4a-2a11c051ac40	2	0	2	4	HRP	0	1	2	3	HRP
df4366c4-170f-4233-b577-a8ea277b069c	3	10	14	27	HRP	2	31	14	47	HRP
df6b025e-ccb7-4f1a-ba22-1dcf76e6554c	0	0	0	0	HRP	0	0	0	0	HRP
df814571-57f1-4e55-bc1a-c892c568c4ba	2	2	2	6	HRP	2	2	2	6	HRP
df8a913c-5160-4fc5-950d-7c890e24e820	7	5	21	33	HRP	6	23	21	50	HRP
df9f8c80-c622-11e3-bf01-24c6515278c0	9	11	4	24	HRP	7	18	4	29	HRP
dfa20d2d-1ba3-476a-b4b9-21d21470bee2	13	4	13	30	HRP	10	9	13	32	HRP
dfde4013-9062-42f5-a42b-626ef8334a41	15	5	14	34	HRP	11	10	14	35	HRP
e04bcdff-3206-4c25-bae9-09f0222b074a	21	13	26	60	HRD	15	39	26	80	HRD
e053d377-e4f2-4aee-af7d-e61605e0f4f5	0	1	2	3	HRP	0	1	2	3	HRP
e07991a4-0901-4ed1-8704-aa376565d862	5	4	12	21	HRP	1	9	12	22	HRP
e07affb1-b6b2-40a4-9c54-0e72f5ea5045	4	3	7	14	HRP	2	7	7	16	HRP
e0aa815f-668a-4de9-bb32-3f215bb7f843	7	2	7	16	HRP	7	6	7	20	HRP
e1217ebe-1826-41a9-b6c4-702100a66f5e	0	1	3	4	HRP	0	3	3	6	HRP
e127e9e4-c622-11e3-bf01-24c6515278c0	5	5	3	13	HRP	4	5	3	12	HRP
e1b169c3-44e0-43e5-9ee3-2df7a678a5ea	1	1	0	2	HRP	1	1	0	2	HRP
e1df938f-1f23-4291-98ef-13db6debb796	4	1	12	17	HRP	3	6	12	21	HRP
e1f0c565-6ed3-4e42-bc3e-c7b0003e837a	0	0	0	0	HRP	0	0	0	0	HRP
e1fc4226-40ce-43b7-b92e-aa7cecd0cf4d	0	0	0	0	HRP	0	0	0	0	HRP
e23462f2-cb86-4a3e-8521-221f4bec247c	1	1	2	4	HRP	1	1	2	4	HRP
e23c591e-c622-11e3-bf01-24c6515278c0	1	1	6	8	HRP	0	1	6	7	HRP
e2774050-1257-4c29-b201-d79ce70fe17e	5	3	7	15	HRP	5	5	7	17	HRP
e2b09705-c5c8-48ee-a90e-19648a7bf2cb	3	3	2	8	HRP	1	3	2	6	HRP
e2b2357c-da6f-4ca3-9c07-a22f0423e8fe	5	13	7	25	HRP	4	17	7	28	HRP
e2b5c926-491d-430d-8d9c-5c73d7752d1b	13	4	16	33	HRP	9	17	16	42	HRP
e2e6a409-b64d-463c-ac3b-e7987a3124f0	9	3	8	20	HRP	5	7	8	20	HRP
e2fa7251-507e-4d76-95a3-a228adc3885a	2	2	3	7	HRP	1	3	3	7	HRP
e30c64d5-e796-4cfc-8dc8-6e62bf97822f	1	0	2	3	HRP	1	0	2	3	HRP
e34bcc5e-c622-11e3-bf01-24c6515278c0	1	2	3	6	HRP	1	4	3	8	HRP
e3eb5217-50e4-49e2-a6fa-f847d091f3c9	2	0	1	3	HRP	1	0	1	2	HRP
e3ef5cad-4d6e-4f04-babb-a908ee02644b	2	4	7	13	HRP	2	7	7	16	HRP
e41bc2ec-3e0b-4c37-806b-3f6f25c8c4db	5	3	3	11	HRP	4	6	3	13	HRP
e45f3391-2e74-4767-817a-280cebac7c57	18	14	24	56	HRD	14	35	24	73	HRD
e4aaca83-3ae9-47f6-a975-c144767ad705	22	12	30	64	HRD	16	42	30	88	HRD
e4c8c7f0-5bac-4d59-91c4-c98207150548	20	18	18	56	HRD	15	44	18	77	HRD
e4fd1b3e-c622-11e3-bf01-24c6515278c0	2	3	2	7	HRP	0	6	2	8	HRP
e5193d7e-e8b7-4098-bf98-8b3a62781d13	7	3	15	25	HRP	4	7	15	26	HRP
e52ffa79-557a-4024-81f3-f3826c227ec5	17	9	23	49	HRP	13	19	23	55	HRD
e541b5b9-546d-47bc-acd6-4006ce0eec1d	1	0	0	1	HRP	0	0	0	0	HRP
e5593865-5f8e-4a4c-b36f-73fbe64d66da	12	5	11	28	HRP	7	15	11	33	HRP
e55f338f-97e2-4394-ae23-c92606069485	16	4	17	37	HRP	8	15	17	40	HRP
e56b0990-ff67-47c1-b9ad-87ef1d4aa2ae	20	4	23	47	HRP	19	13	23	55	HRD
e592e8db-b3d1-4ab5-ae0d-de4b5b4c0f1a	0	0	0	0	HRP	0	0	0	0	HRP
e5c89fcf-cc57-4fad-a138-ea47ee9ea225	0	1	5	6	HRP	0	2	5	7	HRP
e6168db0-d12f-4218-8ab9-bd704201cb2b	8	8	6	22	HRP	6	21	6	33	HRP
e63fac5a-cc48-4ab4-b69d-3f0be6ad684d	0	0	0	0	HRP	0	0	0	0	HRP
e64e9f76-c622-11e3-bf01-24c6515278c0	7	5	9	21	HRP	3	10	9	22	HRP
e6772001-dffc-4fb4-86e9-6c395edd176d	4	4	2	10	HRP	4	5	2	11	HRP
e6801359-d1d7-4871-b2fb-180674a2e469	3	1	2	6	HRP	1	4	2	7	HRP
e68bc7b4-b6b1-4807-b52c-7c7a19cdc373	0	0	0	0	HRP	0	0	0	0	HRP
e6c78a98-f45b-482b-a551-4f11b8c1ff8b	4	2	5	11	HRP	4	10	5	19	HRP
e6eda5db-4d4f-418e-b0d4-ed9b3e5259d3	5	3	7	15	HRP	4	6	7	17	HRP
e6f7344b-951f-4f3f-b140-7bf53164c462	8	8	22	38	HRP	5	28	22	55	HRD
e7048a93-a1ed-4cdc-a1ab-fa507408ca77	9	11	13	33	HRP	6	17	13	36	HRP
e7335a24-e5fc-4558-9eba-511c5a802320	0	0	0	0	HRP	0	1	0	1	HRP
e75fbf08-c622-11e3-bf01-24c6515278c0	1	0	1	2	HRP	1	2	1	4	HRP
e7603fc8-9b73-4c17-86f9-46ca1bceeb1d	11	5	10	26	HRP	8	17	10	35	HRP
e76128b3-8629-4ffd-b02a-e3f0aae8b1a9	1	0	1	2	HRP	1	0	1	2	HRP
e7a0889c-dd8c-4230-9c63-384f1f6ee577	7	7	12	26	HRP	3	12	12	27	HRP
e7c90af0-4b03-453e-b44f-e07248415088	9	9	14	32	HRP	8	13	14	35	HRP
e7d74d34-3255-4c20-90fd-b105e6e229c8	22	14	17	53	HRP	19	25	17	61	HRD
e7dc7492-3a84-49c7-8dea-8f508b53dc40	6	2	5	13	HRP	5	3	5	13	HRP
e7ebc6fb-0926-4c8a-a67b-0c6b9c1ffaba	19	9	26	54	HRD	16	33	26	75	HRD
e8392f20-c9e3-4649-b64f-5b266c393a76	8	9	12	29	HRP	4	12	12	28	HRP
e84debc4-b47d-48ed-a0d0-2859f0ebf987	21	19	24	64	HRD	13	35	24	72	HRD
e84e0649-a2e8-4873-9cb6-1aa65601ae3a	2	4	10	16	HRP	0	11	10	21	HRP
e88397a6-c622-11e3-bf01-24c6515278c0	0	1	1	2	HRP	0	1	1	2	HRP
e89e9c69-ffcd-4a4c-818d-1dee43ddc76a	5	5	8	18	HRP	2	9	8	19	HRP
e9032df3-8692-4146-a867-b9b64c9b310a	9	2	5	16	HRP	6	5	5	16	HRP
e91ab7da-79a6-4ea0-bc24-7aacb39f7614	8	32	22	62	HRD	7	59	22	88	HRD
e93b0979-65ef-4883-9b6e-39eb17966e66	7	4	11	22	HRP	3	14	11	28	HRP
e9445993-854d-44fc-a063-eacf70222fdf	7	5	12	24	HRP	4	9	12	25	HRP
e97ea3d7-9fcd-4df1-9ea8-587cb3be75ec	7	3	12	22	HRP	5	12	12	29	HRP
e98e4e23-a139-4fff-b017-35f3f976eddd	1	0	1	2	HRP	0	0	1	1	HRP
e99ccc0c-c622-11e3-bf01-24c6515278c0	4	0	3	7	HRP	4	1	3	8	HRP
e9cb8877-8e83-46c0-93f0-ea20530c9400	10	7	16	33	HRP	6	14	16	36	HRP
e9d607e8-41c3-4210-870b-a9ab9b1d1c8c	3	4	6	13	HRP	2	6	6	14	HRP
e9d98643-01ee-40c3-a617-e004559625cd	6	7	13	26	HRP	4	15	13	32	HRP
ea121956-77f5-4da3-ab15-0b825469eafe	3	8	10	21	HRP	2	9	10	21	HRP
ea1cac20-88c1-4257-9cdb-d2890eb2e123	15	4	17	36	HRP	10	10	17	37	HRP
ea2055d1-7b8b-4aaf-9a70-8802f4deef9b	6	2	7	15	HRP	5	4	7	16	HRP
ea351a5c-2982-4499-b631-c003deff7d33	1	0	1	2	HRP	1	0	1	2	HRP
ea43434b-197e-48ac-ae2e-46bc7f3776de	51	9	31	91	HRD	46	61	31	138	HRD
ea4a5ca7-86f9-47c7-81be-0c2c669a999f	0	0	0	0	HRP	0	0	0	0	HRP
ea6efcd1-11de-45f0-8bde-f1c06ad27e79	6	6	14	26	HRP	6	12	14	32	HRP
ea7d37ca-0dac-4ae6-ad03-97c6df3d116d	0	0	0	0	HRP	0	0	0	0	HRP
ea83f4e6-d2fa-481e-9e2f-e0489f3cbc93	0	0	0	0	HRP	0	0	0	0	HRP
eab71331-53d3-4cf5-96c9-5121a3962c27	0	1	1	2	HRP	0	6	1	7	HRP
ead1bc2e-42c3-46d9-8f6f-8cb16ba9d2c3	5	4	13	22	HRP	2	21	13	36	HRP
eae45fbe-9f7d-4f59-a0a9-1f0f0d69afc4	0	1	2	3	HRP	0	2	2	4	HRP
eb1531b0-8af1-4b2b-9192-644cb47101fc	15	10	16	41	HRP	12	34	16	62	HRD
eb1792ee-6946-4e0d-bdd1-c924328dba5d	4	4	10	18	HRP	3	5	10	18	HRP
eb18e71d-2a27-4eae-aa27-4b2c0716d2ba	0	0	0	0	HRP	0	0	0	0	HRP
eb588266-c622-11e3-bf01-24c6515278c0	4	4	7	15	HRP	4	5	7	16	HRP
eb59b79f-bd36-4bf4-83e3-2af73bd1d30a	11	3	13	27	HRP	7	9	13	29	HRP
eb9a8f12-6451-43cc-95b3-2e86cf704c96	7	3	19	29	HRP	6	11	19	36	HRP
eba6d269-27f8-4e50-b59a-5d639bdd5cff	1	1	2	4	HRP	1	2	2	5	HRP
ebc1a26b-9582-4756-acd5-b02d1152319d	0	2	1	3	HRP	0	2	1	3	HRP
ebe0ed67-2d3f-45cd-8f9b-4912595b16a0	2	7	2	11	HRP	2	11	2	15	HRP
ebe80d6c-7513-4f5e-9919-669b6d1fa68c	1	1	2	4	HRP	1	3	2	6	HRP
ec16d1f5-f8a9-4c19-8cce-92f6ea9eb3f7	3	7	14	24	HRP	3	8	14	25	HRP
ec23a354-e339-4466-9a1b-8e886ef627e6	0	1	2	3	HRP	0	3	2	5	HRP
ec31e921-0782-4f77-ac23-4190af1e61ee	1	5	5	11	HRP	0	8	5	13	HRP
ec399861-7a56-4ffd-8619-700b6e3a4367	11	2	10	23	HRP	6	8	10	24	HRP
ec43c4b5-fb72-4a4a-af03-10c2d05ff159	1	0	1	2	HRP	0	0	1	1	HRP
ec474dfa-527c-44f3-9224-bf1c858cabfc	8	5	9	22	HRP	5	9	9	23	HRP
ec4d4cbc-d5d1-418d-a292-cad9576624fd	6	4	9	19	HRP	4	9	9	22	HRP
ec5e2990-c622-11e3-bf01-24c6515278c0	4	2	7	13	HRP	3	3	7	13	HRP
ec646623-6d33-4fbd-888e-89f55d82eb11	1	2	3	6	HRP	1	5	3	9	HRP
ec77847e-48fd-4ba5-bc3e-3cd1b149b552	10	4	10	24	HRP	8	11	10	29	HRP
ece0f3a4-a204-4c52-bb1f-88d44a875b2e	4	1	3	8	HRP	4	2	3	9	HRP
ecf4e05a-0912-4b93-ad66-323002f0c845	1	0	4	5	HRP	1	2	4	7	HRP
ecfe388a-99f5-44b9-9226-a6ae6d892538	9	2	14	25	HRP	9	10	14	33	HRP
ed1f5a41-921f-469a-bc04-306a5435e067	1	3	3	7	HRP	1	3	3	7	HRP
ed32c725-08ae-48eb-8fa2-719b9aeb7550	29	13	25	67	HRD	18	42	25	85	HRD
ed46bb2e-97e3-4914-a086-de80e00d6ee8	0	3	1	4	HRP	0	3	1	4	HRP
ed4b53cb-5473-4bc1-9d84-0b0ad93cbd57	11	8	8	27	HRP	9	17	8	34	HRP
ed52e836-c622-11e3-bf01-24c6515278c0	0	1	2	3	HRP	0	1	2	3	HRP
ed7be9ae-e603-4731-8d91-a8285abaee33	0	0	0	0	HRP	0	0	0	0	HRP
eda1d8d9-e8f5-46f2-bb16-15d0b10c2cf9	25	14	13	52	HRP	18	20	13	51	HRP
edac1323-2497-45e6-9148-e9c955292ba2	8	3	7	18	HRP	5	7	7	19	HRP
edc070db-b768-478f-ae75-4c4012bdc3fe	1	0	1	2	HRP	1	0	1	2	HRP
edc8839f-fa6b-41e0-ad49-f688073730bd	24	10	23	57	HRD	21	34	23	78	HRD
eddfbfb9-3ae8-449b-b870-46062a2571c1	31	19	28	78	HRD	23	47	28	98	HRD
edeea137-080d-42d3-a0ce-5cfe0d4a68e7	3	5	0	8	HRP	1	6	0	7	HRP
ee368301-b2f7-428f-9330-67c054c1a09d	0	0	0	0	HRP	0	0	0	0	HRP
ee5d5e7d-78cf-4a29-a9ee-56aa3da877dd	18	5	10	33	HRP	11	15	10	36	HRP
ee6cc68e-8d2a-41ee-82c6-0fecdf7e6259	12	4	12	28	HRP	6	12	12	30	HRP
ee7b8074-c622-11e3-bf01-24c6515278c0	1	3	4	8	HRP	0	3	4	7	HRP
ee8ba991-8c96-476e-b096-49f3aaaffc2f	9	4	17	30	HRP	7	11	17	35	HRP
ee963667-56b1-49bd-8896-e07b536d3014	8	6	8	22	HRP	3	10	8	21	HRP
eeddf701-93f9-4f10-85cb-9dce1760bae8	5	3	2	10	HRP	4	4	2	10	HRP
ef002c3d-358f-4fc0-98f3-2f8b89de4374	16	5	17	38	HRP	13	14	17	44	HRP
ef3a0ccd-85bc-4e5f-a8c6-5a2e2d9e6717	8	6	11	25	HRP	6	10	11	27	HRP
ef3b454c-b2cf-4f68-a2ab-733620b6714e	1	2	0	3	HRP	1	4	0	5	HRP
ef673d3d-2031-4036-ba25-4bc7ef04075b	6	10	8	24	HRP	5	13	8	26	HRP
ef76231d-5a21-4bbd-9847-c01be6fe8916	0	0	0	0	HRP	0	0	0	0	HRP
ef78f09c-c622-11e3-bf01-24c6515278c0	1	5	5	11	HRP	1	8	5	14	HRP
efacd7d6-56cf-4f6a-87f0-1a7ab6b1a643	8	5	8	21	HRP	4	11	8	23	HRP
efbec43c-0c16-4006-abe8-c3ec2ec42c05	18	16	17	51	HRP	14	29	17	60	HRD
efc39172-083c-4297-b922-3f58df781332	6	10	12	28	HRP	4	16	12	32	HRP
efe4d5dd-fffb-41df-ab86-be06cc16646f	15	10	24	49	HRP	9	21	24	54	HRD
efec3225-de07-4559-9a90-95223495cc61	30	25	23	78	HRD	21	38	23	82	HRD
effb868c-f905-41a0-ace1-b5e508732534	1	3	4	8	HRP	1	3	4	8	HRP
f03330dd-c616-4ad5-abc3-6d6b0445e9e9	1	0	1	2	HRP	1	0	1	2	HRP
f047cb85-8f88-45d5-83c3-0416c9f3fff7	0	0	2	2	HRP	0	0	2	2	HRP
f04aecf0-eb12-4ab9-928e-7bcf201b0b40	1	0	1	2	HRP	0	0	1	1	HRP
f064f762-c622-11e3-bf01-24c6515278c0	5	2	4	11	HRP	3	3	4	10	HRP
f075dcdb-4b6a-4186-bfc5-c1787c4a14ac	4	6	4	14	HRP	3	11	4	18	HRP
f0768c67-f38c-40a8-8f27-81a927fb5dca	1	2	6	9	HRP	0	6	6	12	HRP
f07b9192-c86f-4ee4-a3b5-feb9c5098bf4	4	6	7	17	HRP	1	9	7	17	HRP
f0a33adc-ea90-46ef-a24a-a8d7e4e15db3	14	16	31	61	HRD	12	44	31	87	HRD
f0b46dcd-ce45-4405-8744-8f8b35606b75	0	0	0	0	HRP	0	0	0	0	HRP
f0e0d978-3e32-4444-a07a-26049b2594e6	16	5	13	34	HRP	12	10	13	35	HRP
f0f2030e-17fd-4dd9-9104-899e59d72ed8	0	0	0	0	HRP	0	1	0	1	HRP
f1504811-8363-41e6-b43c-62452b1262d3	28	7	23	58	HRD	22	12	23	57	HRD
f1534b2a-5350-442c-bb9d-8c7142668d31	0	0	0	0	HRP	0	0	0	0	HRP
f15989a1-e820-4879-a535-438277acad49	0	1	2	3	HRP	0	1	2	3	HRP
f181848a-c622-11e3-bf01-24c6515278c0	12	9	18	39	HRP	6	19	18	43	HRP
f1a4f60a-5228-47cd-883f-ff8d2dfe1633	10	10	8	28	HRP	8	17	8	33	HRP
f1d73c2f-3d7d-4a0f-871b-b3bf76d865dc	2	5	11	18	HRP	2	9	11	22	HRP
f1d9124e-dfa2-415e-b8b8-dd872fd3e2cb	7	3	9	19	HRP	5	5	9	19	HRP
f1fdacf3-2bb5-400c-895d-ec7f472fa0d4	0	0	0	0	HRP	0	0	0	0	HRP
f21832da-df8b-43d4-9bf4-34ad72b1bcd9	0	0	0	0	HRP	0	0	0	0	HRP
f221c897-6ad0-0df9-e040-11ac0c4813ef	12	7	17	36	HRP	9	24	17	50	HRP
f221cbb5-eefa-187f-e040-11ac0c481708	38	26	31	95	HRD	32	50	31	113	HRD
f24688a9-7952-49d8-ba80-2bbad472379c	2	3	3	8	HRP	1	3	3	7	HRP
f266899a-1dab-4226-a965-bc1327c64080	0	2	0	2	HRP	0	2	0	2	HRP
f269134a-e3d5-4020-bcf5-01fb42f914b2	1	0	0	1	HRP	0	0	0	0	HRP
f26b1f44-12de-43ba-85bb-bc61741a5a88	18	24	29	71	HRD	17	64	29	110	HRD
f283ed80-8302-4f26-99ed-ea20d101289d	9	6	7	22	HRP	6	12	7	25	HRP
f2b2111c-c622-11e3-bf01-24c6515278c0	5	7	12	24	HRP	3	13	12	28	HRP
f2c08ac1-4755-4c36-a11d-338d8df9fa0d	1	4	2	7	HRP	1	4	2	7	HRP
f2d18ad2-2f18-4c1d-8b35-46f999a82f30	1	1	0	2	HRP	1	1	0	2	HRP
f2e639cc-c30c-459f-8afc-7ace7d0209c5	10	5	15	30	HRP	9	22	15	46	HRP
f35f7712-d5c6-47f6-98ed-704edbbc1e19	10	5	22	37	HRP	6	10	22	38	HRP
f3720205-dc76-4101-8a56-72043fc896b5	0	0	0	0	HRP	0	0	0	0	HRP
f37971bd-ec65-4840-8d4f-678692cee695	1	2	2	5	HRP	0	2	2	4	HRP
f37de4fa-52f6-4fe4-a3fa-41803032c93f	20	9	18	47	HRP	16	20	18	54	HRD
f389176f-d8f3-45c2-aae4-7378a3d6fc7f	28	11	32	71	HRD	20	45	32	97	HRD
f38b5d2e-5cab-45c7-bb0a-38b2efc5c156	6	2	22	30	HRP	5	19	22	46	HRP
f38fc6ac-2af8-4d89-a514-4e2c5fdf08de	1	0	0	1	HRP	0	0	0	0	HRP
f393ba16-9361-5df4-e040-11ac0d4844e8	6	5	16	27	HRP	5	14	16	35	HRP
f393baf9-2710-9203-e040-11ac0d484504	43	14	27	84	HRD	31	45	27	103	HRD
f393bafd-1baa-e5f4-e040-11ac0d48450b	13	11	13	37	HRP	7	24	13	44	HRP
f393bafe-7503-5c45-e040-11ac0d484511	16	28	29	73	HRD	11	54	29	94	HRD
f393bafe-c99f-3725-e040-11ac0d484514	30	8	22	60	HRD	26	51	22	99	HRD
f393bb00-888d-710f-e040-11ac0d484518	36	21	32	89	HRD	31	53	32	116	HRD
f393bb01-6ed7-9533-e040-11ac0d484521	26	18	19	63	HRD	17	36	19	72	HRD
f393bb05-53c2-f80a-e040-11ac0d484528	2	7	22	31	HRP	1	21	22	44	HRP
f393bb05-c737-4cc3-e040-11ac0d48452a	10	3	9	22	HRP	8	22	9	39	HRP
f393bb05-ec1c-17be-e040-11ac0d48452f	6	7	24	37	HRP	3	38	24	65	HRD
f393bb07-270c-2c93-e040-11ac0d484533	32	22	25	79	HRD	21	45	25	91	HRD
f393bb08-4121-cad8-e040-11ac0d484535	17	19	24	60	HRD	9	51	24	84	HRD
f393bb08-5b50-e009-e040-11ac0d484537	18	9	26	53	HRP	15	16	26	57	HRD
f393bb0a-9b20-a0e5-e040-11ac0d48454e	7	11	9	27	HRP	5	32	9	46	HRP
f393bb0a-df7d-645c-e040-11ac0d484550	12	7	7	26	HRP	6	12	7	25	HRP
f393bb0b-08ed-3335-e040-11ac0d484554	14	8	19	41	HRP	11	29	19	59	HRD
f393bb0c-3ffa-cb72-e040-11ac0d48455c	16	13	20	49	HRP	10	25	20	55	HRD
f393bb0c-4178-ca4a-e040-11ac0d48455f	14	5	16	35	HRP	11	10	16	37	HRP
f393cfd8-ddbb-a0e1-e040-11ac0d48516b	2	1	2	5	HRP	2	5	2	9	HRP
f39cc911-36a7-4c06-9e91-4ad86281db3d	1	2	4	7	HRP	1	4	4	9	HRP
f3c1a125-06e9-41c4-9558-275a3e346cc5	0	2	2	4	HRP	0	2	2	4	HRP
f4025b40-a249-487f-8e93-7a140bcf57c1	2	4	3	9	HRP	1	5	3	9	HRP
f410b432-c622-11e3-bf01-24c6515278c0	5	19	18	42	HRP	3	30	18	51	HRP
f4798483-9e32-4e6a-8bb5-6f45af2a8ac5	0	0	0	0	HRP	0	0	0	0	HRP
f48c3c82-bebe-4b8e-909e-e1a51a7142ec	17	9	26	52	HRP	15	40	26	81	HRD
f4ada7a2-c4ac-4f89-ada7-4645861002cb	7	11	8	26	HRP	3	15	8	26	HRP
f4b9d98f-7b76-4eaa-9595-10b0973d5ff7	1	1	1	3	HRP	1	1	1	3	HRP
f4baf913-c4ac-46f3-83b6-306b9182207d	6	7	12	25	HRP	1	10	12	23	HRP
f4e673a9-5b85-46e7-bcac-2ce6e1026896	7	2	10	19	HRP	4	5	10	19	HRP
f4e926fd-006e-4c85-b71c-1433c325acb0	11	11	12	34	HRP	9	21	12	42	HRP
f4f48342-c622-11e3-bf01-24c6515278c0	7	4	9	20	HRP	6	9	9	24	HRP
f50fb278-1f0f-406e-b341-eb3d1b97afe6	30	12	23	65	HRD	25	26	23	74	HRD
f5378545-17d4-4a64-a57e-f6c91ef4cb3a	4	5	0	9	HRP	4	11	0	15	HRP
f54442d1-80fa-4678-ac94-c3ad03bc37fb	0	0	0	0	HRP	0	2	0	2	HRP
f54d6b6f-3bc2-41dd-81d0-74cf9e1e90e9	0	0	0	0	HRP	0	0	0	0	HRP
f5a97315-1906-4774-980e-0879c6ad368e	21	6	17	44	HRP	17	27	17	61	HRD
f5bb7ae4-4bb4-4e87-b83c-bc8620584989	9	4	3	16	HRP	4	6	3	13	HRP
f5c8f98a-c34a-49e8-a655-d8f29487b55c	1	0	2	3	HRP	1	0	2	3	HRP
f60007b3-0603-4ad1-8b47-d2d4c4c621e4	1	0	1	2	HRP	1	1	1	3	HRP
f601cf2f-081f-484d-ab0e-21a8ec8d3770	7	4	6	17	HRP	5	7	6	18	HRP
f6114c69-71a1-47d5-9b28-b0227b1872f7	8	6	15	29	HRP	4	18	15	37	HRP
f6189828-eeaa-4d21-b163-53bf3d47a640	20	17	19	56	HRD	12	33	19	64	HRD
f61e794e-c622-11e3-bf01-24c6515278c0	5	3	6	14	HRP	5	3	6	14	HRP
f640d377-98e9-41d3-8761-61eb33072c65	0	0	0	0	HRP	0	0	0	0	HRP
f64e9609-d75d-400c-a92d-d77fd54d6c29	0	0	2	2	HRP	0	0	2	2	HRP
f658c350-fb89-4268-8a59-a07e365f4221	2	2	4	8	HRP	0	4	4	8	HRP
f663ff15-c8d3-4bff-8bf9-bf8e983579e0	1	0	1	2	HRP	1	0	1	2	HRP
f69e5057-eda6-4391-ba9a-aedbf6b572da	32	15	22	69	HRD	24	49	22	95	HRD
f6c811ff-f22e-490b-9b23-b527d20e6e6d	20	24	21	65	HRD	15	33	21	69	HRD
f6e758a5-150f-4424-90b7-1c1a34aec9a3	1	2	6	9	HRP	1	3	6	10	HRP
f7187888-f261-4a39-99b4-966fd7207117	2	3	2	7	HRP	0	4	2	6	HRP
f7702c0c-9636-4700-a8ae-7a58afd9fa71	7	1	9	17	HRP	7	6	9	22	HRP
f7b847e5-0f5d-69b4-e040-11ac0c4845fe	4	3	4	11	HRP	3	7	4	14	HRP
f7b84b5d-8f28-e6b7-e040-11ac0c484704	7	6	14	27	HRP	6	8	14	28	HRP
f7b84bac-f161-9eee-e040-11ac0c4847ed	2	2	4	8	HRP	1	2	4	7	HRP
f7b84c09-15d4-3046-e040-11ac0c4847ff	1	1	2	4	HRP	0	2	2	4	HRP
f7c6486a-bb08-f77a-e040-11ac0c482953	1	1	2	4	HRP	0	2	2	4	HRP
f7c6a336-3126-7580-e040-11ac0c485971	1	1	3	5	HRP	1	2	3	6	HRP
f7c7373c-1972-4968-e040-11ac0d486e80	6	7	13	26	HRP	4	17	13	34	HRP
f7cc504a-37c9-45f5-b50d-599c54dca157	2	1	4	7	HRP	1	8	4	13	HRP
f7d128d2-3964-e3bc-e040-11ac0d481667	4	2	5	11	HRP	3	17	5	25	HRP
f7d70fac-c76f-399e-e040-11ac0c482f9c	10	5	25	40	HRP	10	42	25	77	HRD
f7d77a03-28a0-f446-e040-11ac0c4866fb	0	0	0	0	HRP	0	2	0	2	HRP
f7d7b3db-02af-61cb-e040-11ac0c480c03	1	0	1	2	HRP	0	1	1	2	HRP
f7dcc2e4-1fc4-4b39-bc6a-720e66116d68	21	15	19	55	HRD	17	22	19	58	HRD
f7e4a2a8-093d-9e36-e040-11ac0d480c7d	13	13	21	47	HRP	10	25	21	56	HRD
f7e7b258-b4b2-e6c5-e040-11ac0d486773	11	5	19	35	HRP	8	16	19	43	HRP
f7e7d61f-e2dc-b523-e040-11ac0c482000	1	3	2	6	HRP	0	3	2	5	HRP
f7e9eed5-7a0b-4b2d-bea3-fd8c42a3b90e	1	3	8	12	HRP	0	7	8	15	HRP
f7ed28a6-8f5f-e87b-e040-11ac0c48120e	1	3	8	12	HRP	0	5	8	13	HRP
f7f3e156-0dde-72b9-e040-11ac0d48542c	12	4	18	34	HRP	7	18	18	43	HRP
f7f66114-e321-1d4c-e040-11ac0d48541a	3	2	4	9	HRP	3	12	4	19	HRP
f7f6619b-fae8-3381-e040-11ac0c483f78	1	1	2	4	HRP	0	2	2	4	HRP
f7fdda4f-7bf7-ede7-e040-11ac0c486e57	16	6	5	27	HRP	12	15	5	32	HRP
f80293b8-ddb7-f575-e040-11ac0d48309d	2	0	1	3	HRP	1	3	1	5	HRP
f809247c-2bab-ab06-e040-11ac0d482b8a	6	3	4	13	HRP	4	8	4	16	HRP
f81693ba-09ee-4201-a389-0ceeda8a4636	5	3	8	16	HRP	3	10	8	21	HRP
f82d213f-9843-28eb-e040-11ac0d483e48	0	2	4	6	HRP	0	6	4	10	HRP
f82d213f-9ba5-7b6b-e040-11ac0c486882	15	7	19	41	HRP	12	16	19	47	HRP
f82d213f-bc06-5b51-e040-11ac0c48687e	9	3	9	21	HRP	6	11	9	26	HRP
f82d213f-bc99-5b1d-e040-11ac0c486880	30	7	26	63	HRD	24	35	26	85	HRD
f82d213f-caa7-fd59-e040-11ac0d483e46	1	0	9	10	HRP	0	4	9	13	HRP
f82d2146-70f5-8114-e040-11ac0d483e50	16	16	29	61	HRD	13	70	29	112	HRD
f82d2146-726a-d0e0-e040-11ac0c486888	11	9	16	36	HRP	9	27	16	52	HRP
f83f1eb8-b2c8-c3d6-e040-11ac0c48261e	6	5	10	21	HRP	4	5	10	19	HRP
f83fc777-5416-c3e9-e040-11ac0d482c8e	27	6	32	65	HRD	17	36	32	85	HRD
f8407106-8a96-8f85-e040-11ac0d481656	20	11	26	57	HRD	15	39	26	80	HRD
f841c488-6b8d-6645-e040-11ac0c481418	0	0	1	1	HRP	0	0	1	1	HRP
f8425828-5b0f-23a8-e040-11ac0d484128	5	2	5	12	HRP	1	4	5	10	HRP
f843ed5c-0336-3d33-e040-11ac0d48478c	6	4	13	23	HRP	3	13	13	29	HRP
f845ebba-8c56-b559-e040-11ac0c4863d5	22	12	23	57	HRD	13	26	23	62	HRD
f8467ec8-2d61-ba21-e040-11ac0c483584	0	1	1	2	HRP	0	1	1	2	HRP
f848b66f-bd9e-4fba-afd4-eb58848d1ef4	36	18	27	81	HRD	32	52	27	111	HRD
f8515e5a-7de3-6be3-e040-11ac0c480d6d	1	3	2	6	HRP	0	3	2	5	HRP
f85397dc-e6e9-4f54-e040-11ac0d48706c	18	13	22	53	HRP	12	33	22	67	HRD
f854ae3f-356d-f0ad-e040-11ac0c485dae	7	5	11	23	HRP	3	12	11	26	HRP
f856fa85-fdb8-c0b0-e040-11ac0d480b4e	13	9	18	40	HRP	8	20	18	46	HRP
f8572359-f29a-5945-e040-11ac0d4821cf	11	17	11	39	HRP	8	23	11	42	HRP
f858d813-f3c5-4ad9-8c20-9f231d6624d8	35	14	28	77	HRD	27	49	28	104	HRD
f8593ac0-9480-22a0-e040-11ac0d48697a	25	16	27	68	HRD	20	28	27	75	HRD
f85add3d-e2e6-31f8-e040-11ac0d48479c	35	17	24	76	HRD	31	43	24	98	HRD
f85ae2b7-cebf-17a2-e040-11ac0c48033a	16	10	17	43	HRP	11	23	17	51	HRP
f860bc4c-f31b-6538-e040-11ac0c48268f	12	7	13	32	HRP	7	19	13	39	HRP
f866123a-9eb0-e856-e040-11ac0c48717e	15	14	22	51	HRP	12	48	22	82	HRD
f8696c79-b165-92a6-e040-11ac0c4804bf	7	6	16	29	HRP	6	18	16	40	HRP
f86975a2-78a4-ef8c-e040-11ac0c4809da	17	14	21	52	HRP	12	36	21	69	HRD
f86ae246-2492-9785-e040-11ac0d4813b0	19	12	25	56	HRD	9	33	25	67	HRD
f86b6ba2-8f4b-ee53-e040-11ac0d485904	4	5	14	23	HRP	4	15	14	33	HRP
f86b7e84-7040-c751-e040-11ac0c485675	10	8	19	37	HRP	9	26	19	54	HRD
f86e2d80-911b-7a19-e040-11ac0d486900	9	0	13	22	HRP	6	18	13	37	HRP
f8733b80-c622-11e3-bf01-24c6515278c0	8	5	9	22	HRP	5	9	9	23	HRP
f87348df-7186-4c6b-e040-11ac0c482ba9	13	15	20	48	HRP	8	26	20	54	HRD
f87cdca1-2c85-49d2-e040-11ac0d485c9d	11	9	14	34	HRP	8	17	14	39	HRP
f87d7c27-eeef-920e-e040-11ac0d48388d	18	12	24	54	HRD	13	26	24	63	HRD
f87e94a9-ef37-fcba-e040-11ac0c482332	6	4	9	19	HRP	6	7	9	22	HRP
f87eb1b5-1712-ca1f-e040-11ac0c483848	13	7	10	30	HRP	10	16	10	36	HRP
f8809cee-8f81-28f8-e040-11ac0d4873bf	0	0	0	0	HRP	0	0	0	0	HRP
f89ef95e-6e39-420b-a3c2-ccebcc69ce3b	5	2	2	9	HRP	2	2	2	6	HRP
f8a165b0-51df-413c-b7c6-c7fc80547db4	1	3	1	5	HRP	1	4	1	6	HRP
f8d89ae2-2c7d-40ae-8d40-34b93b16efc9	1	3	4	8	HRP	1	3	4	8	HRP
f8e61a02-654c-c226-e040-11ac0d481b60	0	0	1	1	HRP	0	0	1	1	HRP
f8e61a02-6e5e-c8e2-e040-11ac0d481b70	0	0	2	2	HRP	0	3	2	5	HRP
f8e61a02-8c03-ad45-e040-11ac0d481b62	0	0	0	0	HRP	0	0	0	0	HRP
f8e61a02-8c9e-aaee-e040-11ac0d481b6a	0	0	1	1	HRP	0	0	1	1	HRP
f8e61a02-8fbe-a9af-e040-11ac0d481b64	0	0	0	0	HRP	0	0	0	0	HRP
f8e61a02-909d-a906-e040-11ac0d481b6e	2	1	2	5	HRP	2	1	2	5	HRP
f8e61a02-90ec-96fd-e040-11ac0d481b5e	1	0	1	2	HRP	0	0	1	1	HRP
f8e61a02-92b1-947e-e040-11ac0d481b68	0	0	0	0	HRP	0	0	0	0	HRP
f8e61a02-938b-9428-e040-11ac0d481b6c	0	0	0	0	HRP	0	0	0	0	HRP
f8e61a06-42fa-e42c-e040-11ac0d481b72	0	1	0	1	HRP	0	1	0	1	HRP
f8efa5ad-3a4d-39d6-e040-11ac0c480132	1	1	1	3	HRP	1	1	1	3	HRP
f8efc19a-1e4b-e1b0-e040-11ac0c48104e	0	0	0	0	HRP	0	0	0	0	HRP
f8f0136b-09ec-d079-e040-11ac0c4842e7	1	0	1	2	HRP	0	0	1	1	HRP
f8f024e5-7096-3047-e040-11ac0d481c0f	0	1	1	2	HRP	0	1	1	2	HRP
f8f07989-2e2e-30f3-e040-11ac0d484490	1	0	1	2	HRP	0	0	1	1	HRP
f8f0a423-1a3e-4fcc-e040-11ac0c481cb6	1	0	1	2	HRP	1	0	1	2	HRP
f8f61e36-b934-9410-e040-11ac0c4804cc	0	0	0	0	HRP	0	0	0	0	HRP
f8f749b7-547d-49fa-9da2-44eed962b6fd	4	4	11	19	HRP	3	16	11	30	HRP
f8f7f274-dd98-3bb0-e040-11ac0c483fcd	0	1	0	1	HRP	0	1	0	1	HRP
f8f9d9b8-abdd-1afb-e040-11ac0d480523	6	3	3	12	HRP	2	17	3	22	HRP
f8fae6e5-93b5-7233-e040-11ac0c4830e7	0	0	0	0	HRP	0	0	0	0	HRP
f8fb791c-08b4-b6e1-e040-11ac0d4868f3	0	0	1	1	HRP	0	1	1	2	HRP
f9012277-55c4-2486-e040-11ac0c48236f	0	0	0	0	HRP	0	0	0	0	HRP
f901353f-fdeb-5a55-e040-11ac0c482e89	0	0	0	0	HRP	0	0	0	0	HRP
f901c7f7-891e-8ec1-e040-11ac0c480829	0	0	0	0	HRP	0	0	0	0	HRP
f9020478-c741-6776-e040-11ac0d481228	1	1	1	3	HRP	1	1	1	3	HRP
f9031d03-def1-24b4-e040-11ac0c486570	1	1	1	3	HRP	0	1	1	2	HRP
f9039bd6-8fa6-37cb-e040-11ac0d486d06	0	0	0	0	HRP	0	0	0	0	HRP
f903cfe2-c082-1bf6-e040-11ac0d4809f7	0	1	0	1	HRP	0	1	0	1	HRP
f9052bfc-94a0-cb29-e040-11ac0c48284a	2	2	4	8	HRP	1	3	4	8	HRP
f90a074e-d82f-f6bb-e040-11ac0d487334	0	0	0	0	HRP	0	0	0	0	HRP
f90b298a-0546-6c36-e040-11ac0c487a0b	0	0	0	0	HRP	0	0	0	0	HRP
f90cab09-6797-eccb-e040-11ac0d486aa3	1	1	1	3	HRP	1	1	1	3	HRP
f90d51f8-3bc4-2e66-e040-11ac0d484d19	0	1	0	1	HRP	0	1	0	1	HRP
f90dbdbf-f8cd-e0d8-e040-11ac0c482576	1	0	1	2	HRP	0	0	1	1	HRP
f90f8204-4d65-04fa-e040-11ac0c4841bb	1	1	1	3	HRP	0	1	1	2	HRP
f9101872-d864-c508-e040-11ac0c4818b5	0	0	0	0	HRP	0	0	0	0	HRP
f9116dda-19f4-9e1b-e040-11ac0c4872b8	0	0	0	0	HRP	0	0	0	0	HRP
f91661d6-a2b5-fac2-e040-11ac0d4852fd	1	0	0	1	HRP	1	1	0	2	HRP
f91a9af2-7909-099e-e040-11ac0c484205	0	0	0	0	HRP	0	0	0	0	HRP
f91ba748-5a05-e738-e040-11ac0c486a08	2	0	2	4	HRP	2	0	2	4	HRP
f91bde65-233d-2218-e040-11ac0c480a33	1	0	1	2	HRP	1	0	1	2	HRP
f91d1645-9b68-edbb-e040-11ac0c4854d8	0	0	0	0	HRP	0	0	0	0	HRP
f91faa2e-ea53-bef4-e040-11ac0d485f5d	1	0	1	2	HRP	0	0	1	1	HRP
f920200e-f349-3730-e040-11ac0d4825cc	1	1	0	2	HRP	1	1	0	2	HRP
f920ef57-c942-d2e1-e040-11ac0d481706	0	0	0	0	HRP	0	0	0	0	HRP
f921b592-fa4d-49f7-b773-81a0e903aaed	2	1	3	6	HRP	2	3	3	8	HRP
f92268fe-7a92-51e8-e040-11ac0d48733a	1	0	1	2	HRP	0	0	1	1	HRP
f925f24b-bffd-89ab-e040-11ac0d48682f	1	1	2	4	HRP	0	1	2	3	HRP
f926087f-0bec-1316-e040-11ac0c480a58	1	0	1	2	HRP	1	0	1	2	HRP
f92a34fa-014e-4b41-a6d0-3b46b8c8a3ee	3	5	7	15	HRP	3	8	7	18	HRP
f92a78d1-90ff-70c8-e040-11ac0d485eca	1	0	2	3	HRP	1	1	2	4	HRP
f92b2c52-ed64-4594-e040-11ac0d48425c	1	0	1	2	HRP	0	1	1	2	HRP
f92b8fda-350b-17d5-e040-11ac0c480ce8	0	0	0	0	HRP	0	0	0	0	HRP
f92c8821-daba-3727-e040-11ac0d480224	0	0	0	0	HRP	0	0	0	0	HRP
f92fde51-6a19-6641-e040-11ac0c484074	0	0	0	0	HRP	0	0	0	0	HRP
f937fc8b-6fa7-12fd-e040-11ac0d4850f9	1	1	0	2	HRP	1	1	0	2	HRP
f938b6f4-a457-c624-e040-11ac0c486fad	0	0	1	1	HRP	0	1	1	2	HRP
f939f757-a415-ad44-e040-11ac0d4868e5	0	0	0	0	HRP	0	0	0	0	HRP
f93abbbf-5e13-9b85-e040-11ac0d485718	0	0	1	1	HRP	0	1	1	2	HRP
f93c9e35-c76c-2b59-e040-11ac0d485dee	0	1	0	1	HRP	0	1	0	1	HRP
f93dd46d-4611-e84e-e040-11ac0c483323	1	1	1	3	HRP	1	1	1	3	HRP
f93f4445-6f19-403c-e040-11ac0d48556f	0	0	0	0	HRP	0	0	0	0	HRP
f940cea2-7e79-e422-e040-11ac0d483224	0	0	1	1	HRP	0	0	1	1	HRP
f942b732-7c0b-7ec6-e040-11ac0c483f86	0	0	0	0	HRP	0	0	0	0	HRP
f94c4f69-8119-4eaf-97c1-5106890c14d4	7	5	17	29	HRP	6	12	17	35	HRP
f9718c44-c622-11e3-bf01-24c6515278c0	7	5	11	23	HRP	5	8	11	24	HRP
f9837a56-7244-4846-a63d-266e6a92f168	6	10	12	28	HRP	5	18	12	35	HRP
f9854144-d92c-46da-ac87-9d1fd7efe67d	7	9	0	16	HRP	7	20	0	27	HRP
f988e698-9b34-45ce-ba4c-74e06e9cae4a	26	29	25	80	HRD	17	45	25	87	HRD
f98de26b-c7d6-435d-81fa-1f1869da9087	8	2	5	15	HRP	7	6	5	18	HRP
f9a81200-5381-496a-8062-099f9e793618	1	1	3	5	HRP	0	3	3	6	HRP
f9c07ba7-152a-f624-e040-11ac0c484cd5	0	0	2	2	HRP	0	0	2	2	HRP
f9c0a08b-d1e5-4c18-e040-11ac0c4864df	2	1	2	5	HRP	1	3	2	6	HRP
f9c0a0d9-5af6-4476-e040-11ac0d4830d3	3	3	1	7	HRP	0	8	1	9	HRP
f9c0a12c-2651-d9ea-e040-11ac0d483201	4	4	4	12	HRP	2	5	4	11	HRP
f9c1df10-25b8-c8ae-e040-11ac0d486375	1	2	0	3	HRP	1	5	0	6	HRP
f9c23ce8-7f1c-9417-e040-11ac0d482562	5	5	2	12	HRP	5	6	2	13	HRP
f9c23d09-74e4-07f9-e040-11ac0d482577	0	0	0	0	HRP	0	0	0	0	HRP
f9c26646-d2b0-cf30-e040-11ac0d483918	5	7	3	15	HRP	2	9	3	14	HRP
f9c39eb7-39a9-6626-e040-11ac0d4870c2	3	0	1	4	HRP	2	11	1	14	HRP
f9c3bc8e-dbc4-1ed0-e040-11ac0d4803a9	2	2	1	5	HRP	1	2	1	4	HRP
f9c3e4e3-1b95-b71a-e040-11ac0d4819e7	2	2	0	4	HRP	2	7	0	9	HRP
f9c3eaad-a0d9-8bf8-e040-11ac0d481d8e	8	9	3	20	HRP	8	25	3	36	HRP
f9c4e06c-e8a6-613b-e040-11ac0d4828ba	0	0	0	0	HRP	0	0	0	0	HRP
f9c51617-3fcb-91c5-e040-11ac0d484abf	5	6	0	11	HRP	5	11	0	16	HRP
f9c52187-2e82-d58a-e040-11ac0d484fc4	1	1	2	4	HRP	1	5	2	8	HRP
f9c52414-385d-8cc7-e040-11ac0d485037	1	2	0	3	HRP	1	6	0	7	HRP
f9c650e7-9053-78eb-e040-11ac0d4874bb	7	6	0	13	HRP	5	11	0	16	HRP
f9c65e3d-f3f7-dd5f-e040-11ac0d487b1f	2	2	0	4	HRP	2	4	0	6	HRP
f9c6f4ca-4bb8-26b4-e040-11ac0d485600	0	0	0	0	HRP	0	0	0	0	HRP
f9c70e38-dd99-3fe2-e040-11ac0d4862f2	6	4	2	12	HRP	5	7	2	14	HRP
f9dc999f-6dde-448d-9cf1-2897ddcf7b0b	1	6	17	24	HRP	1	21	17	39	HRP
f9f04e42-63a2-4ee1-ade4-9e5bb5c20cdd	2	1	4	7	HRP	1	7	4	12	HRP
fa2c3620-7e82-4b12-b135-87986f0f2890	1	6	7	14	HRP	0	11	7	18	HRP
fa4d35e3-fc38-4e26-a9e0-521a648acec1	3	4	4	11	HRP	2	6	4	12	HRP
fa54205f-7e51-4e5a-9f0a-5e8a2e40235f	11	10	12	33	HRP	6	12	12	30	HRP
fa5e2900-95e7-4700-9707-a329cd0c77fd	0	0	0	0	HRP	0	0	0	0	HRP
fa676301-902f-473f-8313-5bff34ae549a	2	2	8	12	HRP	2	8	8	18	HRP
fa6a60f5-8949-4e01-9435-d3117601627f	9	9	17	35	HRP	6	19	17	42	HRP
fa718a69-7d09-424b-90a3-4839ba7dc9b2	0	0	0	0	HRP	0	0	0	0	HRP
fa837b4d-55a7-4dcf-9fdf-cf9c13644df7	0	0	0	0	HRP	0	0	0	0	HRP
fa8844f8-c4b6-487a-8187-e30c12a7a453	13	3	14	30	HRP	10	8	14	32	HRP
fa9996c3-b874-4424-a5a6-f1c7c0f42b9b	0	0	0	0	HRP	0	0	0	0	HRP
fa9a3247-a465-4fdf-bb64-5afaa83a5d76	4	4	4	12	HRP	3	5	4	12	HRP
fab0be4b-c84a-45cd-a76f-44d9a8bf1846	15	6	21	42	HRP	10	24	21	55	HRD
fab3d6f4-de1c-4d6c-bdea-ac39a7884657	12	5	10	27	HRP	9	11	10	30	HRP
fabf1f6c-c622-11e3-bf01-24c6515278c0	9	11	16	36	HRP	5	16	16	37	HRP
fae88d21-171c-4df4-b258-3c5948a1034b	1	2	2	5	HRP	0	2	2	4	HRP
faff4626-615b-416a-b7a6-9d177dcc94a9	10	9	21	40	HRP	7	16	21	44	HRP
fb0c6353-a90c-45e2-9355-7cd16cf756ff	15	11	20	46	HRP	7	22	20	49	HRP
fb194ca3-10aa-4dc5-8d08-619ddbd6d1b6	0	1	2	3	HRP	0	4	2	6	HRP
fb74cca4-ac9c-4be0-80e3-e71592f96aae	1	2	2	5	HRP	1	2	2	5	HRP
fb8b5ff5-4164-4276-b75b-b0ee6bda7329	5	3	5	13	HRP	5	9	5	19	HRP
fb9135d9-2acf-41dd-8552-359e6b8c9470	10	7	31	48	HRP	7	36	31	74	HRD
fbd899a0-c622-11e3-bf01-24c6515278c0	9	8	15	32	HRP	6	14	15	35	HRP
fbea74b5-b1a8-4767-af7c-e179ce8da071	0	1	2	3	HRP	0	1	2	3	HRP
fbf937f1-5f30-470c-8a77-46cd1c41e073	0	0	4	4	HRP	0	4	4	8	HRP
fc009c3d-66fc-4b9c-ae43-014607e3723a	4	4	4	12	HRP	2	6	4	12	HRP
fc249113-83d4-4abe-8c80-a4f7305dcd91	12	7	14	33	HRP	8	20	14	42	HRP
fc447d4f-2532-c8ea-e040-11ac0c48469f	29	21	21	71	HRD	19	38	21	78	HRD
fc447d51-cdc2-a180-e040-11ac0c4846a4	21	8	24	53	HRP	14	46	24	84	HRD
fc447d53-24d1-c83d-e040-11ac0c4846a6	13	3	15	31	HRP	9	22	15	46	HRP
fc447d55-95d8-0b34-e040-11ac0d483afa	17	9	17	43	HRP	12	27	17	56	HRD
fc447d56-0d53-e0c3-e040-11ac0c4846a8	29	14	22	65	HRD	15	22	22	59	HRD
fc453f67-6623-4e8c-b519-0bd79e4d4651	10	3	6	19	HRP	8	7	6	21	HRP
fc5dc6d8-62d2-76d8-e040-11ac0d4863c3	7	14	27	48	HRP	3	33	27	63	HRD
fc639186-8302-798e-e040-11ac0c484cec	17	11	17	45	HRP	8	18	17	43	HRP
fc63cbab-d27a-5ebb-e040-11ac0c48724f	37	19	31	87	HRD	31	48	31	110	HRD
fc68c24d-47ad-7961-e040-11ac0c48595c	34	20	27	81	HRD	26	50	27	103	HRD
fc68e599-6a40-61dc-e040-11ac0d48700d	25	10	21	56	HRD	16	18	21	55	HRD
fc6d77a9-121b-48ab-a899-713c3d1319a2	35	22	27	84	HRD	22	46	27	95	HRD
fc78685a-7053-152a-e040-11ac0c480ded	23	7	19	49	HRP	14	11	19	44	HRP
fc7eb420-5c13-20bd-e040-11ac0d484574	37	15	22	74	HRD	28	38	22	88	HRD
fc7f8eeb-9c40-123e-e040-11ac0c484061	13	3	21	37	HRP	12	23	21	56	HRD
fc806c50-2f6e-418d-e040-11ac0d485f01	36	11	27	74	HRD	25	36	27	88	HRD
fc812906-d3b6-4210-a842-96f095280cbf	0	0	0	0	HRP	0	0	0	0	HRP
fc8130df-18fe-c74d-e040-11ac0d485df2	4	1	5	10	HRP	2	6	5	13	HRP
fc8130df-1bc2-c537-e040-11ac0d485de6	6	1	7	14	HRP	4	1	7	12	HRP
fc8130df-1cdd-cade-e040-11ac0d485dec	1	0	2	3	HRP	1	1	2	4	HRP
fc8130df-1e8f-c879-e040-11ac0d485df4	6	3	4	13	HRP	5	14	4	23	HRP
fc8130df-1f21-c8f9-e040-11ac0d485dfc	3	6	8	17	HRP	2	10	8	20	HRP
fc8130df-2211-cfcc-e040-11ac0d485dde	14	14	16	44	HRP	12	36	16	64	HRD
fc8130df-24d9-32f1-e040-11ac0d485df0	3	0	3	6	HRP	3	3	3	9	HRP
fc8130df-2628-304a-e040-11ac0d485dfa	3	0	6	9	HRP	3	0	6	9	HRP
fc8130df-297f-34a3-e040-11ac0d485e02	1	0	4	5	HRP	0	2	4	6	HRP
fc8130df-2ca4-39d2-e040-11ac0d485e00	2	0	4	6	HRP	1	2	4	7	HRP
fc8130df-2d5f-3b53-e040-11ac0d485dee	14	3	11	28	HRP	10	10	11	31	HRP
fc8130df-2e39-3814-e040-11ac0d485de0	5	7	7	19	HRP	2	11	7	20	HRP
fc8130df-30a5-3e6a-e040-11ac0d485de2	26	20	25	71	HRD	21	37	25	83	HRD
fc8130df-3147-3e94-e040-11ac0d485df8	3	0	3	6	HRP	1	0	3	4	HRP
fc8130df-3225-3f96-e040-11ac0d485dfe	4	5	6	15	HRP	4	9	6	19	HRP
fc8130df-3361-3c8a-e040-11ac0d485dea	4	2	10	16	HRP	3	11	10	24	HRP
fc8130df-34f8-22c6-e040-11ac0d485de8	6	4	6	16	HRP	4	10	6	20	HRP
fc8130df-35ac-2304-e040-11ac0d485dda	15	5	10	30	HRP	13	19	10	42	HRP
fc8130df-6860-7677-e040-11ac0d485ddc	12	24	23	59	HRD	9	46	23	78	HRD
fc8130df-6977-7704-e040-11ac0d485de4	5	6	9	20	HRP	3	10	9	22	HRP
fc8130df-6bec-7627-e040-11ac0d485e04	33	15	24	72	HRD	26	23	24	73	HRD
fc8130df-897d-5404-e040-11ac0d485e0a	11	4	8	23	HRP	8	16	8	32	HRP
fc8130df-8e4e-586b-e040-11ac0d485e08	2	1	10	13	HRP	1	7	10	18	HRP
fc8130df-8ec8-5b1e-e040-11ac0d485e06	40	16	20	76	HRD	29	31	20	80	HRD
fc8130df-90ba-5d94-e040-11ac0d485e0c	29	18	22	69	HRD	19	43	22	84	HRD
fc8130df-e399-e34d-e040-11ac0c483279	9	5	7	21	HRP	6	14	7	27	HRP
fc8130e0-08dd-b996-e040-11ac0c48327b	14	7	12	33	HRP	11	22	12	45	HRP
fc8130e0-095f-b953-e040-11ac0c483287	3	2	3	8	HRP	2	5	3	10	HRP
fc8130e0-096a-b991-e040-11ac0c48327d	6	5	5	16	HRP	3	10	5	18	HRP
fc8130e0-09f1-b964-e040-11ac0c48326e	8	7	19	34	HRP	7	23	19	49	HRP
fc8130e0-0b9c-bbc9-e040-11ac0c483266	5	3	4	12	HRP	2	3	4	9	HRP
fc8130e0-0bc1-bba7-e040-11ac0c483289	6	1	11	18	HRP	2	3	11	16	HRP
fc8130e0-0bfa-bba4-e040-11ac0c48328d	4	0	5	9	HRP	3	5	5	13	HRP
fc8130e0-0c53-b432-e040-11ac0c483283	1	0	3	4	HRP	0	3	3	6	HRP
fc8130e0-0d25-b475-e040-11ac0c483277	2	0	2	4	HRP	0	2	2	4	HRP
fc8130e0-0db6-b568-e040-11ac0c483281	2	0	4	6	HRP	1	1	4	6	HRP
fc8130e0-0dcf-b558-e040-11ac0c483285	7	7	13	27	HRP	4	11	13	28	HRP
fc8130e0-0e1f-b54d-e040-11ac0c48326c	25	12	28	65	HRD	20	29	28	77	HRD
fc8130e0-0f1a-b6eb-e040-11ac0c48328f	25	23	25	73	HRD	23	44	25	92	HRD
fc8130e0-0fde-b756-e040-11ac0c48328b	13	12	10	35	HRP	8	21	10	39	HRP
fc8130e0-a38a-23b9-e040-11ac0c48327f	24	18	30	72	HRD	14	67	30	111	HRD
fc8130e0-a39a-23b5-e040-11ac0c483270	2	2	2	6	HRP	1	4	2	7	HRP
fc8130e0-a538-dda3-e040-11ac0c483264	10	6	19	35	HRP	8	19	19	46	HRP
fc8130e0-a539-dda8-e040-11ac0c48326a	6	3	16	25	HRP	5	13	16	34	HRP
fc8130e0-a774-d834-e040-11ac0c483268	10	5	16	31	HRP	7	17	16	40	HRP
fc8130e0-a8b4-d80d-e040-11ac0c483272	2	5	13	20	HRP	1	14	13	28	HRP
fc8130e0-a94d-d9d0-e040-11ac0c483262	9	5	8	22	HRP	6	11	8	25	HRP
fc8130e0-ad63-b804-e040-11ac0d485e10	2	1	2	5	HRP	0	2	2	4	HRP
fc8130e0-ad66-b82e-e040-11ac0d485e0e	7	3	8	18	HRP	6	7	8	21	HRP
fc8130e0-ad8a-b832-e040-11ac0d485e14	2	2	4	8	HRP	1	7	4	12	HRP
fc8130e0-aed2-bb2f-e040-11ac0d485e12	10	6	13	29	HRP	4	16	13	33	HRP
fc8130e2-f2ef-d096-e040-11ac0c483293	6	8	11	25	HRP	4	15	11	30	HRP
fc8130e3-01ba-c740-e040-11ac0c483291	20	19	33	72	HRD	17	58	33	108	HRD
fc8130e3-023d-c7d4-e040-11ac0c483295	7	9	22	38	HRP	3	18	22	43	HRP
fc8130e5-18b8-ef38-e040-11ac0c483297	14	4	17	35	HRP	10	17	17	44	HRP
fc81312a-99ae-7672-e040-11ac0c4832a2	8	7	13	28	HRP	5	20	13	38	HRP
fc81312a-d451-38fb-e040-11ac0c4832a4	4	3	6	13	HRP	3	4	6	13	HRP
fc813235-5ed8-7695-e040-11ac0d485e3e	30	16	30	76	HRD	25	77	30	132	HRD
fc876f51-0577-3b53-e040-11ac0d48515e	0	0	0	0	HRP	0	0	0	0	HRP
fc876f5c-8339-bc9c-e040-11ac0d485160	0	0	2	2	HRP	0	3	2	5	HRP
fc876f66-ff0d-f338-e040-11ac0d485162	0	0	0	0	HRP	0	0	0	0	HRP
fc8edf46-2005-1af4-e040-11ac0d481414	5	11	21	37	HRP	5	35	21	61	HRD
fc93369d-3ffb-1b53-e040-11ac0c4852ba	0	0	0	0	HRP	0	0	0	0	HRP
fc93b9ab-760a-5223-e040-11ac0c482177	16	8	19	43	HRP	9	24	19	52	HRP
fc93bd81-a3f9-2f8e-e040-11ac0d48306f	0	0	0	0	HRP	0	0	0	0	HRP
fc93e38d-6bd5-9912-e040-11ac0c4838cd	0	0	0	0	HRP	0	0	0	0	HRP
fc9404ed-1ba3-2638-e040-11ac0c484da2	0	0	0	0	HRP	0	0	0	0	HRP
fc9469d0-4d0e-bb59-e040-11ac0d481e59	0	0	0	0	HRP	0	0	0	0	HRP
fc94ea15-2d98-0c5b-e040-11ac0c48569b	1	0	1	2	HRP	1	0	1	2	HRP
fc94ec40-2cf2-7ce8-e040-11ac0d4871fb	0	0	5	5	HRP	0	0	5	5	HRP
fc9500f3-e7d0-9820-e040-11ac0c48617e	2	1	3	6	HRP	2	1	3	6	HRP
fc950c33-faa4-0241-e040-11ac0c486786	1	3	5	9	HRP	1	7	5	13	HRP
fc95d5ce-6899-62f1-e040-11ac0c486011	11	10	10	31	HRP	7	15	10	32	HRP
fc962061-8ab0-42b3-e040-11ac0c4810cc	15	6	13	34	HRP	9	12	13	34	HRP
fc9650a1-9aef-ab3b-e040-11ac0c4829a7	8	5	6	19	HRP	5	7	6	18	HRP
fc968a86-32e3-ee88-e040-11ac0d487adb	5	4	7	16	HRP	4	9	7	20	HRP
fc969f27-bdc6-cd03-e040-11ac0c48577e	10	2	10	22	HRP	9	8	10	27	HRP
fc96e36c-67f1-4c02-e040-11ac0d48393d	0	0	0	0	HRP	0	0	0	0	HRP
fc96f0df-ef04-411e-e040-11ac0d484291	0	0	0	0	HRP	0	0	0	0	HRP
fc975588-6e70-b496-e040-11ac0c484689	3	2	6	11	HRP	3	4	6	13	HRP
fc97c1c5-9f4a-be90-e040-11ac0c480992	4	1	3	8	HRP	4	1	3	8	HRP
fc990cee-3a1e-9d45-e040-11ac0c484ab3	0	2	6	8	HRP	0	8	6	14	HRP
fc99832e-a4ae-8259-e040-11ac0c48131c	0	1	3	4	HRP	0	2	3	5	HRP
fc998aec-57dd-eab2-e040-11ac0d48680a	0	0	0	0	HRP	0	0	0	0	HRP
fc99b734-7f61-88d1-e040-11ac0c482e88	0	0	0	0	HRP	0	0	0	0	HRP
fc99bbb0-e5c7-fb9e-e040-11ac0d4807e1	0	0	0	0	HRP	0	0	0	0	HRP
fc9d5fc6-546f-27b7-e040-11ac0d485f87	0	0	0	0	HRP	0	0	0	0	HRP
fc9d5fc6-719b-0525-e040-11ac0d485f83	1	1	0	2	HRP	1	2	0	3	HRP
fc9d5fc6-7f7d-1313-e040-11ac0d485f85	1	7	3	11	HRP	1	10	3	14	HRP
fc9d5fc7-a87b-c5e7-e040-11ac0c4850aa	0	0	0	0	HRP	0	0	0	0	HRP
fc9d704c-0cfb-0407-e040-11ac0d486980	5	3	5	13	HRP	2	6	5	13	HRP
fc9d93b6-77c6-8719-e040-11ac0d487dec	4	5	0	9	HRP	4	7	0	11	HRP
fc9d93b6-92e8-acb7-e040-11ac0d487dee	4	1	3	8	HRP	1	3	3	7	HRP
fc9dbf68-4599-3c64-e040-11ac0d481623	17	2	14	33	HRP	13	7	14	34	HRP
fc9ef456-75a2-5967-e040-11ac0c484477	6	8	14	28	HRP	2	10	14	26	HRP
fc9f6916-da31-ab17-e040-11ac0c4808f3	34	25	31	90	HRD	26	59	31	116	HRD
fc9f6cb0-ceb9-790d-e040-11ac0c480ad1	47	11	30	88	HRD	37	74	30	141	HRD
fc9f9295-01f6-a9e0-e040-11ac0d4845af	4	1	3	8	HRP	1	3	3	7	HRP
fc9f998b-cc72-f6ea-e040-11ac0c482425	2	2	0	4	HRP	2	4	0	6	HRP
fca04929-586a-0594-e040-11ac0c48099d	2	1	0	3	HRP	1	2	0	3	HRP
fca07e09-1fd2-9ef5-e040-11ac0d485bbd	31	14	16	61	HRD	23	33	16	72	HRD
fca08ee9-b480-4dc7-be56-f1eb03b56f7c	4	4	5	13	HRP	3	13	5	21	HRP
fca1c663-dec0-db39-e040-11ac0c486140	0	0	0	0	HRP	0	0	0	0	HRP
fca2d62f-2756-939e-e040-11ac0d4865e6	1	0	0	1	HRP	0	0	0	0	HRP
fca3f7d0-2231-661c-e040-11ac0c4832fd	13	6	23	42	HRP	5	15	23	43	HRP
fca6150f-d555-a29e-e040-11ac0d4873b2	11	7	22	40	HRP	5	19	22	46	HRP
fccb865d-83ed-4bfe-ad84-0689813ae977	3	3	7	13	HRP	1	6	7	14	HRP
fce8d8c6-f2a0-43a8-9a7a-b9c519a6686c	7	15	13	35	HRP	6	23	13	42	HRP
fd163b56-1c2d-4e63-9fad-ba3221ae274b	2	3	0	5	HRP	2	3	0	5	HRP
fd504153-3cf6-44b9-99d5-21961ebac188	15	7	13	35	HRP	11	13	13	37	HRP
fd74de4d-6973-4597-a541-e8a13d80ad55	0	6	3	9	HRP	0	6	3	9	HRP
fdbd0277-ddbf-4cc5-8ec3-3644b9553627	12	5	18	35	HRP	5	15	18	38	HRP
fdf7dfb7-9285-46b3-be60-672164507705	6	9	4	19	HRP	6	11	4	21	HRP
fdf9a814-c622-11e3-bf01-24c6515278c0	3	2	4	9	HRP	0	2	4	6	HRP
fe04d042-a4cc-4a14-8197-415ea40951aa	33	28	27	88	HRD	23	58	27	108	HRD
fe083d2d-d088-4ac1-825b-8c5bbfe974ac	2	3	0	5	HRP	2	3	0	5	HRP
fe4611c2-bd37-4605-adfe-60efe0392b03	0	0	1	1	HRP	0	0	1	1	HRP
fe63d42b-d471-45b6-9bdf-1a3b55465d37	2	2	0	4	HRP	1	2	0	3	HRP
fe8c62a6-c113-46e8-ab91-fdb90bb6a59f	6	5	13	24	HRP	5	13	13	31	HRP
fe96d91c-3686-4125-af71-b8703a011ad4	7	8	20	35	HRP	3	19	20	42	HRP
fea5827b-251d-474b-8713-fc76db995fe7	27	27	29	83	HRD	20	59	29	108	HRD
fec30898-f86b-4207-aa78-de77142c8f50	1	2	4	7	HRP	0	2	4	6	HRP
feccc27e-5c2e-4339-8746-0945fee93c1e	13	4	10	27	HRP	7	5	10	22	HRP
feccee20-a62d-4152-b832-b9fdaca87a61	22	8	21	51	HRP	16	21	21	58	HRD
ff3fe4a3-7d19-4d4d-81b6-aaa41ba5bf39	13	17	25	55	HRD	10	34	25	69	HRD
ff870342-f0d6-4450-8f9c-344c046a0baf	3	2	0	5	HRP	3	6	0	9	HRP
ffa976f0-aa60-4867-842e-361afa7d68ac	0	0	0	0	HRP	0	0	0	0	HRP
ffad9288-c622-11e3-bf01-24c6515278c0	10	8	17	35	HRP	7	16	17	40	HRP
ffb4f42b-58e9-40c3-8963-11804f041375	1	1	2	4	HRP	1	3	2	6	HRP
ffdd4feb-aca3-4104-b1e8-954d705a6450	7	4	11	22	HRP	2	10	11	23	HRP
ffe4bb51-e98a-41a7-a4e1-c3970386889c	6	5	9	20	HRP	5	13	9	27	HRP
